schoef aan bovenkant : schroef platte plaat
piramide aan bovenkant : piramide
rust op driehoek : wijnglas
afgesneden driehoek bovenkant : afgesneden piramide
balk bovenop horizontaal : robot
kopje met lepel : balk door bol
tafel als plateau : tafel eettafel
twee ruiten bovenkant : schaap
cillinder kegel rondje : ovalen steun onderkant
twee cillinder bol : zonnepaneel
bol driehoek zijkant : bol platte balk
rond plateau vuurwerk pijl : bijzettafeltje met tuutje
plateau lijkt zwembad : zwembad
balk naar beneden : balk voor mok
twee cillinders bovenop : glijbaan
twee ronde kegels : rechtopstaande lepel sliert
verrekijker sateliet : verrekijker
punthoed wielen neus : punthoofd
rechte lijnen figuren : graal beker houder
motor van boot : deurklink
raketmotoren : hanenkam
neus piercing : neuspiercing
plank houder : bakje plank
pinokkio wetenschap kunst : boiler
suiker pot : theekopje
rollen schuine plank : buis door kopje
indiaan : indiaan
trechter kom plaat : taart houder
zwembad trap afscheiding : pippi langkous
balhoofd armen neus : basketbal armpjes
glijbaan speelplaats : glijbaan
theepot tol : vijzel
stapels vierkante blokjes : spijker scherm blokjes
hanenkam en puntneus : hanekam vierkant cirkel
trofee met blokjes : gedraaide balk driehoek
gelijk aan teken : afgekapt hoedje is teken
vierkante staaf liggend : shuttle balkje bovenop
vierkant balletje cirkel : staaf bolletje cirkel
mengkom door tafel : tafeltje met schoteltje
langwerpig hexagon neus : doorboord vierkant glijbaan
halve cirkel kegel : blokje onderin cirkel
bolletjes twee stokken : scherm achter spijkers
bolle neus driehoek : bolletje driehoek staafje
spijker schuin hartje : spijker hartje schijf
vierkante ondergrond : kralen vierkanten plaat
vierkante stok vooraanzicht : bolletje armen staaf
schuine cilinder vierkant : tutu torens
kegels vierkantjes zijkant : ballonnetjes vierkanten blokjes
vierkant oog met twee schroef oren : champignon kapsel robot
scherp driehoekige pet : pyramide pet
mogelijk mensenlijk lichaam : menselijke trofee
pastoor achtig hoedje : pastor met een is teken
rechthoekig balk op de beker : robot stofzuigende snoepmachine
appelvormig beker : clown toeter
tafel vormig pet : ouderwetse pistool
satelliet kop met pinokkio neus : pinokkio sitcom satelliet
oude camera toestel : oude zijwaartse cameratoestel
dikke handvaten beker : elektrische fiets meter
een watermeloen neus : onkruid schotel
pacman oortje : pacman helicopter landing
symmetrische koffie beker : diamanten kop koffie oren
hangende koffie beker : moderne lantaarnpaal lamp
een groetende robotje : groetende stofzuiger robot
boomstam in beker : twee waterdruppels
stekker robot vierkant : robot plaat antenne
piramide trapezium : piramide pipet
pirouette armen omhoog : cocktailglas pirouette
kip duckface hanenkam : eend kip
lampenkap schouders balk : lampenkap balk
neuspiercing kuifje staaf : doorboord ei
opgetilde plank bakje : plantenbak opgetild tafeltje
wijzend been omhoog : ruitjes oude camera's
basis koffie deksel : pannetje deksel kegel
superman armen wijd : peper zout paaseitjes
ronde neus staartjes : ei wolkenkrabber hoofd
trechter bijzettafel reling : b vormige reling bijzettafel
zwembad kralenketting : clown zwembad kralenketting
plank knuffel geven : wolkenkrabber knuffelen
tutu slurf hendel : tutu slurf hendel
telescoop twee hendels : oude camera kegels
antenne erop : antenne blokjes plaat
driehoekige punt erboven : driehoek punt blok
op spiraal staaf : trofee driehoek plateau
twee uithangbordjes rechts : uithangborden lampenkap staartje
liggende staaf erop : balk erop vleugeltjes
viekant door bol : zuignap
bakje op plank : tafeltje bakje
blokjes door ruit : erachter ruit blokken
ronde plaat erachter : ronde plaat erachter
staaf bol uiteinden erdoor : staaf bolletjes zonnescherm
driehoekig prisma zijkant : bolletje bowlingpin
rond dienblad rechts : trompet
spiraal erdoor : drie puntjes rondje
balletje erop : staaf bol armpjes
plaat erdoor : plaat erdoor slurf
blokken rechts voor : blokken rechts eruit
symmetrisch vierkant vlak uitsteeksel : vlak voorkant paddestoel
puntig compact complex : driehoek erop
complex puntig lang : spiraal driehoek bodem
hoekig afgevlakte punt : handel afgevlakte driehoek
symmetrisch complex puntig balk op de bovenkant twee half ronde uitsteeksel aan de zijkant : kapjes zijkanten balk erop
bekend rond uitsteeksel : balk door de bol
puntig lang : tafel mok of bakje
symmetrisch puntig twee blokkige uitsteeksel bodem en rechts : twee vierkanten met handels van kleinere kubussen
niet symmetrisch afgevlakte onderkant cirkel aan de achterzijde : cirkel achter balk erdoorheen
langwerpig voorwerp dwars doorheen vlak afgerond : cilinder achterkant twee bolletjes
bolvormige object aan de voorkant twee puntige uitsteeksels een uitsteeksel aan linkerzijde : bal voorkant uitsteeksel zijkant
puntig complex interessant : mok tafeltje lang gerekte pion
vlak vierkant bodem cirkel voorkant : platte cirkel voorkant
langwerpig ronde form bovenkant : bal op balk voorkant
complex puntig compact : slurf aan de voorkant plaat door heen
kopvormig vier uitsteeksel : cilinder bocht achter
robothoofd met plaat : robot
spitse punt omhoog : spitse punt
getordeerd : trofee
twee rechthoeken zijkant : platte driehoek
v goot : kip
stamper door neus : staaf door ei
tafel met trechter : tafel en bakje
zeepaardje : zeepaardje
zeshoekige staaf zijkant : zeshoekige staaf zijkant
aanknooppunt voor boten : staaf twee ballen
v goot zijkant : v goot zijkant
toeter op arm : toeter
geruite handvatten : zes ruiten zijkanten
bal op emmer : staaf verticaal bal
emmer in vierkant : vierkant midden emmer
twee ronde handvatten : telescoop
laserogen antenne : links groterwordende vierkanten
voetjes snavel mohawk : driehoek achterop telescoop
tornado onderaan : wokkel met driehoek
trapezium bovenop : trapezium bovenop
schoonmaakrobot : schoonmaakrobot
heeft een snor : appel steeltje doorboorde neus
rand rondom : tafel met bakje
doorboorde ruit bovenop : vierkanten door ruiten
kopje met citroen schijf : cirkel achterop appel steeltje
armen en matje : waterval twee armen
pennenbak met neus : roerstaaf voor verf
vastgeplakt aan kauwgom : oude spijker plateau
pippi langkous : pippi langkous
korfbal korf met armen : korf met bal
in een plaat : platform doorboort glijbaan
links en boven dezelfde : lepel boven links
telescoop ogen : twee telescopen
driehoek boven : scherpe driehoek
gedraaide onderkant : gedraaide onderkant
vogeltje : vogeltje
balk boven op : omgekeerd bekertje
neus met staaf : neus doorboord
tafeltje met bakje : tafeltje met kom
kat : kat
beker met roerlepel : beker met lepeltje
horizontale doorlopende staaf : schans en spijker
midden bovenste rij : neus met pennetje
spijker en plateau : schijfje met spijker
rij met ruitjes : macaroni
balletje boven op : bolletje ongelijke armen
twee balkjes boven : vlak met slurf
joystick boven op : telescoop met pennen
uitschuifbare blokjes : paddestoel kaas plakje kijkes
hoge piramide : piramide koekje schroef
omhoog gaande draaimolen : beker trofee
vogel met twee snavels : hoedje vogel twee snavels
stofzuigende robot : robot stofzuiger
langwerpige neuspiercing : neuspiercing
ophang plankje : tafeltje houder bakje
bloempot op een stokje : klappen een standvlak
pinokkio : cocktail halve cirkel
centraal riolering punt : klep riool bolletjes
dikke indiaan : indiaan omgedraaide kegel
bijtelen : spijker plateau
pan vaas afwassen : afwas houder doorboord
bal in korfbal mandje : korfbal houder bal
waterglijbaan : glijbaan
twee dezelfde pluimen : identieke pluim
stekker : robot met paddenstoel
tent : tent
bier beker : wijn glas
vis : kuikentje
graan machine : chicken little
kop koffie : piercing
picnic tafel : tafel met bakje
pinokkio : pinokkio
sauteer pan : cocktail
ernergie centrale : courgette
indiaan clown : neus fancy lepel
bestuuringssysteem : casino royaal
kruk : pippi langkous
basketbal hoop : basketball hoop
maal machine : boot met tutu
blender : stofzuiger
vierkant voorkant : spijker vierkant
piramide driehoek bovenkant : piramide
uitsteeksel onderkant lang : driekhoek onderkant
twee rechthoeken rechts : hoedje twee rechthoeken
meest compact : compact
klein uitsteeksel bovenkant : stokje door neus
twee pootjes onderkant : kruiwagen
meest complex : dier
verlengde onderkant : lepeltje halve circkel
handvaten rond uiteinde : schuin vierkant achterkant
neus en oor : neus driehoekje lepeltjes
trechtervormig uitstekend linksboven : dienblad
vierkant aan onderkant : vierkant onder kopje
verticale rechthoek : armen lange rechthoek
vierkant door object : vierkant door midden
ovaal boven links : theepot
pot antenne armen : antenne twee wolkenkrabbers
driehoek hoedje : piramide feesthoedje
kalk trophee blokjes : trophee
toilet spoeler staartje stekker : stekker afgevlakte piramide
boekentas houder boek : boekentas krantenbak
gewichtheffen spring haartje : neuspiercing spring haartje gewichtheffen
schap hanger bloempot : bloempot schapje
armen ster uitstekels : bliksem ruitjes
nek pinokkio : pollepel pinokkio
gestrekte armen : krantenbak grote rugzak
neus antennen oor : ronde neus
rond dienblad splinter : splinter rond plateau
dienblad cirkel kopje : pippi langkous onderzetter
balk bal houder : basketbalnet bal
twee uitsteekseltjes : tabakspijp glijbaan
tong uit mond : doorboord wolkenkrabbers
vierkant aan zijkant : twee minecraft vierkant
driehoek bovenop : driehoek bovenop
staand op driehoek : wijnglas
twee horizontale balkjes : vogeltje
horizontaal balkje bovenop : middelvinger
balk door bolletje : stampot stamper
plateau twee schuine pootjes : bankje twee pootjes
gebogen balkje onderkant : ruitjes gebogen balk
rond balkje links : voetstuk theelepel handvat
twee bolletjes zijkanten : twee knobbel handvatten
ei zijkant : ei twee uitsteeksels
rond plateautje zijkant : spijker rond plateau
op vierkant plateau : drie bolletjes
bolletje bovenop : verticale balk ei
vierkant plateau halverwege : plateau doorheen schoorsteen
drie kubusjes zijkant : minecraft twee handvatten
plaat verrekijker handvat : gekanteld plaat handvat
feesthoed blok : feesthoed
hoog spiraal blokjes : cocktail
uitlaat dakje staven : parallele balken
gootje balk jets : boek buisje
bol staaf schijf : bal balk schijf
tafeltje bakje : tafeltje
dubbele plaat : parallele platen
zeshoek schijf : halve maan
vlak staven bollen : honkbal knuppel
bol gootje hendel : bal rare druppel
schijf toeter : schijf dubbel uitsteeksel
grondvlak bolletjes : bolletjes onderplaat schijf
bal balk symmetrisch : bol balk handvaten
plaat hoek buis : bierviltje
kijker hendels uitlaat : twee grote druppels
plat schroef torens : robot
hoedje en onderstel : potlood open kegel
kelk lang beker : kelk
vogelbekdier staartje hoeje : perry het vogelbekdier
ruimte chip boot balk : koffiezetapparaat ruimteschip
lepel toeter : indiaan lepel toeter
tafel bakje : tafel
grijper ruit gewicht : grijper met ruit
pinokkio druppel cirkel : pinokkio neus cirkel lepel
fiets hendels vierkant deksel : piemels
vulpen bol neus : vulpen neus driehoek
opwindbaar rond plateau : toeter en plateau
plateau spiralen : spiralen bogen plateau
bal handvaten staaf : fietsstuur balk bol
plateau staaf hendel : glijbaan plateau
vier lange uitstulpsels : kegels toren flubbertje
groot vierkant voor : helikopter
piramide bovenop : piramide
de trofee : trofee
twee rechthoeken rechts : twee rechthoeken rechts
liggende staaf bovenop : saaie gebouw
paal door bolletje : neuspiercing
diepe gootsteen : geweer of gootsteen
dansende pinokkio kop : pinokkio
kopje op houdertje : op houdertje
gieter : gieter
beslagkom met mixer : dartpijl
omgekeerde pillon links : pillon
zes kralen : kralen
bal bovenop : bal bovenop
minder diepe gootsteen : gootsteen hendel links
twee uitstekende tampons : tampons
robot met antenne : geblokte armen antenne
poppetje met feestmuts : mannetje met feestmuts
een benig juichend poppetje : standbeeld op statief
zittend poppetje met stekels : vogel met beentjes
hoofd met hanenkam : recht balkje mouwtjes
poppetje met ontstopper : appel met stamper
etende kat aan tafel : schuin bakje tafel
opspringende hond : springend hondje
steelpan met lepel : steelpannetje met lepel
gieter met handvat : balk door lichaam
ronde neus hoofd : schuine kegel rondje
spijker arm poppetje : spijker rails rondje
poppetje met vlechtjes : twee kralen armpjes
een benig rond hoofdig poppetje : cirkel armpjes balk
dj langwerpige neus : langwerpige neus handje
cactus plant met uitsteeksels : cactus met uitsteeksels
verrekijker met antenne : twee verrekijkers
stromend waterstraaltje : twirl
stopcontact rechts : stekker
mini glijbaan links : nikszeggend balkje bovenop
neuspiercing plukje haar : neuspiercing
stoel tafel bakje : tafeltje met soepkom
uitsteeksel beneden rechts : olifantje
omgekeerde druppel ondersteuning : stokje links staartje
uitsteeksels met bolletjes uiteinden : theekan
bolletjes neus oor haartjes : neus twee antennes
spijker rechts plateautje : plateau met trompet
kralenketting horizontaal : staartjes
mand eitjes pilaar : paal aan voorkant
links arm slurf : slurf plaat erdoorheen
enkele verrekijker : een verrekijker
spion met verrekijker : spion
misvormd puntig gezicht : vreemde vis
juichend persoon : juichend persoon
angry bird vogel : angry bird
stokstijf persoon : stokstijf persoon hanekam
gezicht met neuspiercing : neuspiercing
kruiwagen met bakje : kruiwagen
robot op eenwieler : robot op eenwieler
pinokkio toilet : pinokkio
watergieter : gieter
clown ronde neus : clown ronde neus
drukpers met plankje : drukpers met hendel
drilboor met handvaten : pippi langkous
waterpomp met bal : waterpomp met bal
stofzuiger door grond : stofzuiger slurf
stuurwiel van schepen : pier in appel
verrekijker : verrekijker met paddestoel
feesthoedje : feesthoed met potloodpunt
tulp op driehoek : tulp op driehoek
f vorm : f vorm
pinguin : pinguin
doorboorde neus : doorboorde neus
tafel met kom : tafel met schaaltje
karate trap : karate trap
beker met citroen schijf : beker met citroen schijf
armen en rugzak : vliegtuig vleugels rugzak
neus en vulpen : vulpen en neus
rond dienblad : omgekeerde pion
gootsteen met ketting : gootsteen met kraaltjes
armen en ei : armen en ei
doorgesneden pot : doorboord snijplank slurf
propellor : propellor met staart
antenne en vierkant : antenne vierkant voor
boven punt driehoek : raar blok driehoeks punt
scheve stengel wijnglas : wijnglas
hoedje twee balkjes : deksel twee uitsteeksels
vleugels vierkant bovenuit : spaceship met huisje
pilaar door bolletje : neuspiercing
tafel door kopje : tafel met kopje
spijker door vierkant : wasbak doorgeprikt vierkant
potlood door kopje : potlood cirkel lepel
staaf door kopje : achterklep stangen
speer staaf neus : geen piercing hoofd
spijker door arm : spijker bijtafel
kopje op platform : plaat circkel sprieten
pilaar bol armpjes : poppetje met balk
platform door kopje : middel platform glijbaan
plantenbak vierkante arm : vierkanten twee stengels
groot vierkant voorkant : robot
feestmuts en wielen : feestmuts
draaiend wijnglas : wijnglas
eend met uitlaat : is teken
liggende balk bovenop : neus met balk
staaf door ei : zuignap
halve tafel poten : bijzet tafel poten
meeste balken uitsteeksels : kraan
ronde plaat achterkant : pinokkio
lange korte vlaggenmast : andere lengte uitsteeksels
balken voorkant ei : theelepel ei neus
links uitstekende nier : spijker bijzettafel
twee strengen vierkantjes : drie vierkantjes
lange balk voorkant : fietsmand
olifanten slurf twee schoorstenen : slurf vierkant doorheen
twee dichte parasols : deegrollers
vierkant ervoor : paddenstoel vorm bovenop
puntige driehoek bovenop : scherpe driehoeks punt bovenop
driehoekige gedraaide verhoging : gedraaide staaf onderaan
twee strepen zijkant : stompe punt bovenop
horizontale staaf bovenop : horizontale balk bovenop
staaf door bolletje : staaf door bolletje
horizontale plank ervoor : horizontale plank ervoor
ruit bovenop : doorgestoken ruit bovenop
halve cirkel achterkant : half rondje erachter
zeshoekige staaf bolletjes : ovaaltjes op staaf uiteinde
kegel staaf bovenop : volledig balletje voorop
horizontale cirkel schijf : horizontale ronde schijf
diamant stengels zijkanten : diamanten bovenop plaat
verticale langwerpige staaf : verticale balk ervoor
halverwege door vierkant : vierkant horizontaal doorheen
groeiend vierkant voorop : groeiend vierkant zijkant
schoorsteen op kopje : kopje met schoorsteentje
punt bovenop kopje : piramidedak en wijnflesje
driehoekig pootje : wijnglas
rechts twee balkjes : kluisdeur met deurklink
balkje op kopje : koffie tuitje en rechthoek
houder met zuignap : beker met zuignap
steun balkjes rondom kopje : kuipje bovenop balk
tuitje onderaan kopje : tuitje aan onderkant
achthoekig handvat links : ovale onderkant
lange horizontale staaf : lange horizontale cilinder
punt staafje in kopje : twee verschillende roerstaafjes
spijker op handvat : spijker en dienblaadje
ruitjes aan weerszijden : zes diamantjes ondergrond
rechthoekige poot rechts : waterpomp achtig met standaard
vierkant snijdt kopje : glijbaan en armpje
drie verschillende handvaten : drie handvaten
twee uitdijende kubussen : paddenstoel bovenop
driehoek bovenop : driekhoek bovenop
wokkel onderaan : wokkel schroef
twee uitstekende rechthoekjes rechts : afgesneden piramide bovenop
liggende rechthoek bovenop : lampenkap zijkant
mini pluimpje linksboven : bol staaf erdoorheen
uitstekend tafeltje : tafeltje
doorgestoken ruit bovenop : ruiten uitstulpende kubussen
gedeeltelijke cirkel achterkant : keukenmachine
achterzijde uitstekende klep : zout potjes
vier verschillende uitsteeksels : drie uitsteeksels en bol
links uitsteeksel omhoog : toef met vierkant bovenop
platte cirkel voorop : zes dingetjes
ovaal bol bovenop : rechthoek vooraan geplakt
identieke mini staafjes bovenop : links l vorm
uitdijende kubus rechterzijde : twee identieke pluimen
dun rechtopstaand vierkant : robotarmen
piramide bovenop : punthoed
driehoek helemaal onderaan : ijscoupe
vierkantjes rechterzijkant : varkentje
brede staaf bovenkant : broodrooster
zuignap koffielepel schuin : zuignap
dienblad bij bovenkant : dienblad bakblik
driehoek met aanhangsel : biscuitje
smalle ronde onderkant : koffiekoekje
lijkt op gieter : gieter
driehoekig uitsteeksel zijkant : ei voorkant
oorvormig uitsteeksel zijkant : oor
vierkante onderzetter : spiraal vlechtjes
bol bovenop : ei bovenop
vierkant rond midden : stekkertje bovenop
rechtopstaande brede koffielepel : slurf
twee legoblokken links : twee legoblokken links
puntige piramide bovenop : piramide bovenop
driehoek eronder hangend : draaiing naar driehoek
afgeplatte conus bovenop : is teken
platliggende rechthoek bovenop : platliggend balkje bovenop
rechthoek door bol : kannibaal met piercing
bezet plateau rechtsboven : plateau met pootjes
iss achterop boven : iss bovenop
halfronde schijf bovenop : half rondje achterop
strandstoel linksboven : honkbalknuppel met strandstoel
rechthoek rechtop bovenop : kannibaal zonder piercing
trompet linksboven : hartje met toeter
confetti slinger erachter : op een plateau
bol bovenop : armpjes met bol
vierkant minirokje : glijbaan en snijvlak
legoblok rechts : regenpijp links
blokken armpjes vierkant : blokjes piramides spijker
tent trapezium cirkel : circustent trapezium koekje
taartpunt blok schroef : trofee
is tekentje hoedje pinokkio : is tekentje keppeltje
rechthoek tuit schep : neus omgedraaid
lantaarnpaal ei heft : piercing
picknickbankje piemeltje trapezium : parkbankje
pinokkio ploeg linkerarm : ruitje blokken piramides
pinokkio cirkel heft : ronde schijf hendeltje
gieter vierkant handvat : gieter zonnepaneeltje
vulpen lineaal ei : vulpen pennenbakje
bleekselderij cirkel spijker : bleekselderij spijker
platform kralen armpjes : drie bolletjes
omarming ei pilaar : knuffelaar ei
glijbaan hoek platform : konijntje
negen uur blok : negen uur blokjes piramide
paddenstoel bovenop : paddestoel groeiende kubussen
op wielen vlieger : vlieger
trofee gedraaid kubusje : trofee
varken links gekanteld : varken
vleugeltjes lange rechthoek : kip watertap
doorgestoken ei : doorgestoken ei lepel
tafel twee stoelpoten : tafelpoten staartje
pinokkio liggende zandloper : groeiende kubussen armen
drankje citroen lepel : lepel citroen
ijzeren pin erdoorheen : zwaard
ei omgekeerde kegel : ei kegel
ijspegel cirkel : ijspegel c
zwembad met trapje : symmetrisch
lange balk voorkant : ei armen balk
linkerarm zwevend vierkant : glijbaan schoorsteentjes
negen uur : negen uur
robot ogen vierkant : robot
hoedje neus oor : neus piramide
standaard vierkant driehoek : statief beker
onderzeeer boot : duikboot piramide
bootje vinnen staaf : duikboot pinnetje
neus piercing staaf : neus piercing
tafel pootjes : tafeltje pootjes
kraan sateliet : kraantje
lepel staaf onderkant : lepeltje onderkant citroen
staaf benen staart : deegroller staaf
neus clown : lepeltjes neus arm
plateau draaien : bankschroef plateau
vierkant oren clown : clown wokkels
hoofd armen neem : knuffel armen staaf
rokje arm : rokje vierkant
lepel staart armen : mannetje lepeltje
verrekijkers : verrekijkers
punthoed : punthoed
langwerpig : langwerpig
vogel : vogel
grote neus : lego poppetje
gootsteenontstopper : gootsteenontstopper door neus
hoge plank : hoge plaat
grijphaak : ruit met grijphaak
gestrekte armen : armpjes
zijkant gezicht : kegel hoofd
dienblad : ober
basketbal : basket
danseres : robot danseres
speldenkussen : speldenkussen
paddenstoel bovenop : torentjes en paddenstoel
driehoek bovenop : tent
vierkant blok bovenop : driehoek gedraaide balk
platte uitsteeksels rechts : is teken
balk bovenop : de compacte
bol met uitsteeksels : ding door bol
tafel er doorheen : picknicktafel
ruit uitsteeksels bovenop : ruit met torentjes
uitstekende cilinder links : die lang duurde
uitsteeksels met bol : ongelijke uitstekende dingen
bol voorkant : twee verschillende uitsteeksels
spijker uitsteeksel links : spijker
ligt op plateau : drie bolletjes
balk rechtop voor : losstaande balk
kleine uitsteeksels boven : plaat er doorheen
cactus in pot : plant in pot
bovenstuk van microscoop : mixer met antenne
hondenkop met feestmuts : hondenkop met feestmuts
een potige vogel : kip
vijf vinnige vis : vijf vinnige vis
hondenkop met kuif : hondenkop met kuif
persoon met neuspiercing : man met neuspiercing
tweepotige mok houder : plateau met pootjes
dansend schaap : dansend schaap
urinoir met hendel : mok op kano koekje
korte vlag houder : lucifer met mok
beslagkom voor eieren : mok met roer spaantjes
houtwerk met spijker : houtwerk met spijker
complexe halsketting hanger : mok met kraaltjes
olifant met bolhoedje : korf voor balsporten
waterpomp met plateau : waterpomp met plateau
olifantenhoofd met blok aanhangsel : mok met roer handvaten
plat vierkant rechterkant : paddestoel bovenop
piramide bovenop : piramide bovenop
kubus rechts bovenop : wijnbeker
trapezium bovenop midden : kip
horizontale balk bovenop : compact
bol rechts midden : ei staaf erdoorheen
horizontale plaat middenin : tafel twee pootjes
l vorm onderkant : boek twee trappetjes
halve cirkel linksboven : halve cirkel bovenop
weerskanten staaf bolletjes midden : twee zoutvaatjes weerskanten
bowlingkegel links bovenop : ei penseel linksboven
rond plateau rechterkant : rond plateau rechts
plat vierkant onderop : spiraaltjes weerskanten
verticale balk rechts : verticale balk
plat vierkant onder midden : l vorm links
kegel middenin bovenop : trapje twee kegels
kubusjes vierkant zijkanten : muur plakker spijker kubusjes
driehoek bovenop : kogel pyramide
driehoekig pootje eronder : cocktailglas
twee rechthoeken rechts : onderzeeer deur
oorbellen en hanenkam : uitlaten hanenkam neus staaf
plukje haar neuspiercing : neuspiercing plukje
plank erdoor bovenin : bankje cakevorm
drie uitstulpsels rechtsonder : doorboord boek handvaten
pannetje deksel lepel : steelpannetje lepel deksel
gieter met klepje : rare gieter
ongelijke oren bovenop : tandenborstel bakje
spijker pacman zijtafel : pacman spijker zij tafeltje
plank eronder : paardenstaartjes plank eronder
bol bovenop : armpjes rechthoek bolletje
plank erdoor onderin : glitch plankje slurf
kubusjes rechter zijkant : staartje uitsteeksels kubusjes
paddestoel vierkant wolkenkrabbers : verrekijker paddestoel vlak
piramide wiel champagnefles : piramide champagnefles blok
mannetje voetstuk twister : trofee voetstuk spiraal
hoedje uitlaat forklift : hoedje uitlaat balken
balk voetjes driehoek neus : balk voetjes voorstuk
neuspiercing voetsteun oortje : neuspiercing korfbalpaal staartje
tafel bakje pootjes : tafeltje poten bakje
voet ruiten arm : voetje vliegtuig staart neus
kegeltje voetstuk cirkel : voetstukje cirkel cilinder
lucifers afdak ondersteuning : lucifers honkbalknuppels afdakje
bolle neus oren : konijntje bol oren
b toeter tafeltje : beamer tafeltje koker
kraantjes oren ruitjes : vierkant spiraal oren kraantjes
balk bol armen : balken knuffelaar bol armen
cilinderachtige neus konijnenoren : doorgesneden vlak oortjes
worm kegels trap : kegels pijp wolkenkrabber
twee staven links : tv
halve kegel boven : tent als neus
beneden staaf driehoek : spring poppetje
twee liggende rechthoeken : twee staven rechts
liggende rechthoek bovenop : rechthoekige staaf bovenop
staaf door neus : staaf door neus
tafel bak bovenin : tafel met blok
vierkant staaf bovenin : spekje
lepel cirkel bovenin : verhoging
staaf links rechts : peper en zout
staaf rechthoek bovenin : sims teken
links staaf tafelpoot : dienblad en tafelpoot
midden cirkel staven : drie kralen
rechthoek verticaal beneden : verticale grote staaf
plateau horizontaal midden : rokje
staaf boven links : blokkendoos als neus
vierkant voorop : vierkant aan voorkant
driehoek op bovenkant : wiel onderaan
wijnglas met standaard : wijnglas
vijf uitsteeksels : is teken rechts
balk op bovenkant : staaf op bovenkant
paal door neus : staaf door neus
hoofd met bril : picknicktafel
lange neus : ruit achterop
half rondje bovenkant : smal voetstuk
twee rondjes : scherm aan achterkant
rondje rechtsmidden : verf kwastje en staaf
rechts ronde schijf : dienblad rechts
staat op vierkant : op vierkanten voetstuk
rondje op bovenkant : rondje bovenop
vierkant om middel : vierkant om middel
vier lange uitsteeksels : vier uitsteeksels
vierkant gezicht : vierkant op gezicht
feesthoedje : feesthoedje op hoofd
been voet : been
feesthoedje zonder punt : lijkt op stekker
omgedraaide beker oren : balk op hoofd
neuspiercing : neuspiercing
picknicktafel op hoofd : picknicktafel op hoofd
pinokkio : twee ruiten hoofd
rondje op achterhoofd : links kijkende pinokkio
twee verschillende armen : twee knots armen
alleen bolle neus : alleen ronde neus
beamer : rond dienblad
diamanten oren : diamanten uit oren
verticale neus : verticale neus
slurfje : slurf en tutu
twee kegels snavel : omgekeerde snavel
schroef bovenkant vierkant : schroef in hoofd
puntig hoedje : verjaardags hoedje met punt
langste object voet : poppetje gekromde benen
is teken zijkant : half verjaardags hoedje
compact zonder uitsteeksels : balk bovenop hamer
schroef door bolletje : neuspiercing
railing zijkant pyramide : spoiler tafel
lichaam gebogen voet : mijn favoriet
langwerpig verhoogd platform : ronde pilaar cirkel
armen schuin dak : diploma hoedje
rond bolletje zijkant : ronde neus voor
spijker in arm : spijker arm
object op platform : clown op platform
poppetje balk zijkant : mannetje omarmt balk
twee streepjes bovenkant : rokjes platform pijp
twee ronde jongleer stokken : diabolo's
blokkentoren handvatten links : twee blokken handvatten links
driehoek links bovenop kopje : driehoek linksboven
vierkant rechtsboven rand : draaikolk onderin driehoek
twee staafjes rechts : is teken rechts
rechthoekige staaf bovenop : rechthoekig blok bovenop
theelepel linksbovenin kopje : theelepel linksboven kopje
plankje twee pootjes : plankje poten bakje
blokkerige satelliet bovenop : vierkante satelliet linksboven
lepel rechts boven : onderzetter koffielepel rechtsboven
steun plateau achter kopje : rugsteun ongelijke handvatten
twee verschillende lepels : staafdiagram lepel
handvat met tentharing : tentharing linker handvat
handvaten drie balletjes : handvatten drie bolletjes
balletje drijft linksboven : balletje linksbovenin kopje
gelijke staafjes bovenop : gelijke staafjes bovenop
drie lange handvatten : blokken handvat rechts
verrekijker : omgekeerd hondje
driehoek bovenaan : hoedje driehoek
lijkt op wijnglas : wijnglas
bevat is teken : is teken
hanenkam korte mouwen : espresso apparaat
rechthoek door neus : neus met staaf
horizontale rechthoek bovenaan : bankje tafeltje
een arm en been : helikopter
theepot deksel linksachter : theekopje met deksel
vierkant bovenstuk paardenstaart : ongelijke armen
liniaal in pennenbak : theemok twee lepeltjes
rondvormig dienblad vasthouden : dienblad en spijker
pippi langkous vlechten : pippi langkous
een bol bovenaan : bol bovenaan
vierkante tutu : tutu
wortelvormige neus haar : uitsteeksels legoblokjes slurf
satelliet met antenne : robot met antenne
piramide bovenop : tovenaar vierkante neus
gedraaid uitsteeksel onderkant : wijnglas gedraaide poot
is teken en minteken : is teken en minteken
vinnen beiderzijds : haaienvin met balk
balletje op stokje : poppetje met neuspiercing
tafel met bakje : tafeltje met bakje
satelliet vormig uitsteeksel bovenop : satelliet en staart
mok lepel koekje : kopje lepeltje rondje
gieter met dakje : gieter met handvat
kegel rechthoek bovenin : strip en zandloper uitsteeksel
kegel uit pacman uitsteeksel : plateau en selderij
kralensnoer op plateau : meisje met vlechten
armen en hoofd : mannetje met paal
glijbaan op plateau : zwaaiend met rokje
uitgerekte kubus rechts : twee verschillende lepels
verrekijker met walkie-talkie antenne : verrekijker
verjaardags hoedje op wieltjes : piramide twee wieltjes
sierlijk gedraaide voet : gedraaide voet
split in oorlel : afgeplat trapezium bovenop
pinguin met hanenkam : pinguin
assymetrische dikke neus piercing : neuspiercing
platte bril : bril plankje
benige : gespiest ruit op voet
pinokkio op richel : schijf achter op richel
gespiest schuin afdakje : bolletjes spies plat dak
dikke bolle neus : twee stokjes complex
ober met neus toeter : ober met spijker
symmetrisch met onderplaat : twee sprietjes op vierkant
gekruisigd aan paal : knuffelende gekruisigde jezus
zwemmen met gebalde vuist : vierkant rokje
whatever pinokkio punt haar : twee kegels verrekijker
twee armen controller : paddestoel vierkant kubus
driehoek hoofd : driehoek trapeze cirkel
standbeeld op pilaar : wijnglas taartpunt vierkant
trapeze twee balkjes : is teken trapeze
notitie maken rechts : goudstaaf kap
wc ontstopper met rondje : wc-ontstopper cirkel staaf
dienblad eetbak : dienblad bakje
zeepaard staart oren : zeepaardje ruit kubus
pollepel staaf rond : plateau cirkel achter
balk door midden : kanon staafjes ei
kom lepel bolletje : cirkel lepel staafjes
schroef balk dienblad : spijker cirkel
vlechten spiegel platteau : dna cirkel vierkant
zijkant lange balk : ei staaf balk
vierkant rondom slurf : zeven slurf vierkant
staart armen antenne : kubus staafjes slurf
vierkant plateau rechts : robot verrekijker
piramide bovenop : driehoek muts
gedraaide balk onderaan : juichen omgekeerde hond
twee balkjes rechts : twitter vogeltje
vierkant balkje bovenop : gezicht twee oren
voorkant rondje balk : neuspiercing
rechts balk driehoek : pan doorheen gezakt
bovenaan vierkant staaf : dansende poppetje
achterkant cirkelvormig plateau : cocktail pinokkio
uitstekende balken rondje : honkballer
voorkant rechts rondje : bowlen pion
links grote spijker : spijker
vierkante onderzetter : plateau feestslingers
vooraan lange balk : bol.com man
vierkant midden omheen : meisjesrok fabriek
twee ovalen staven : miereneter
spijker op mok : normale spijker
gedraaide pilaar : struisvogel
flappy bird : flappy bird
dun cilindertje ernaast : balk
spijker door bol : indiaan met piercing
twee potig platform : tafel
negentig graden opzetstuk : doorboord boek
doorboord glas ijsthee : ijsthee
ronde horizontale paal : zout en peper
bol en uisteeksels : indiaan zonder piercing
dolk in balk : pacman
wokkel oren : wokkels
rechte verticale paal : breed
henry stofzuiger : glijbaan fabriek
vier uitsteeksels : de moeilijke
vierkant vlak : wolkenkrabbers aan kopje
driehoek : soort tentvorm
schroefvorm op driehoek : soort cocktailglas
is teken : soort is teken
soort masker : robot of uiltje
bol en schijfje : bolletje met stang
soort zwevend bankje : soort zwevend bankje
grootste object : wafelvorm bovenop
kom op verhoging : kop afgeronde balk
tafel in kom : tafeltje in mok
penseel in kom : penseel vorm
soort serveerschaal : ronde platte schijf
kleine kubusjes : vierkant met fonteintjes
lange smalle balk : uitstekende lange balk
ronde balk : ronde lange balk
meerdere ronde handvaten : kegelvormen negentig graden
robot antenne vierkant : robot spijker plaat
geometrisch hoedje : hoedje kogel
draaien : draaiende voet
usbs staart hoedje : usbs staart papieren boot
symmetrisch waterafvoer raket boosters : oorbellen balk
plantenbak citroen stamper plukje : ijsthee stamper
tafel : tafel
ninjaster als dumbbell : dumbbell ruit
pot still oude camera : oude camera pinokkio
draai emmer paneel : armen paneel draai emmer
puntig rond geometrisch : ijsthee prikker zonder ijsthee prikker
kaneelstokje helicopterplatform batman signaal : batmanlogo kaneelstokje helicopterplatform
symmetrisch natuurlijk breed : spiralen schotel octopus arm
armen plank : dunne armen
plat doorgezakt semi symmetrisch : boot slang l
deegrol handels oude usb : deegrollen
blokkige verrekijker : verrekijker vierkant
grote piramide bovenop : piramide bovenop
gedraaide steunpoot : dna spiraal driehoek blok
twee rechts uitstekende blokken : afgevlakte piramide bovenop
horizontaal rechthoek blok bovenop : vierkante balk bovenop
neus met paal : neus plus ring
bumper driekwart hoogte : bumper piramide omgedraaid
verticaal vierkanten boven : sik
cirkel achter hoofd : op plateau
horizontale buis : zonnepaneeltje bovenop
rechthoekig uitsteeksel middenboven : bolle neus
niervormig uitsteeksel links : plateau rechts
grote vierkante onderplaat : twee staartjes horizontaal
bal bovenop : bol bovenop
vierkante plaat middenhoog : vierkante rok midden
blokkig uitsteeksel rechts : vierkante kijker rechts
ruimteschip twee motors : ruimteschip
piramide bovenop : piramide en kogel
troffe draaiende hendel : beker
nespresso cupje bovenop : kip
compact rechthoekje bovenop : wall-e
neus met piercing : neus met piercing
plank hoog : schap met bakje
pinokkio gek hoedje : karate kid
ronde deksel achterop : pinokkio met plukje
hamer : hamer met standaard
neus zonder piercing : neus zonder piercing
spijker in hendel : eiffeltoren serveerster
op grote snijplank : pippi langkous
ei bovenop kopje : omhelzing
plank door kopje : olifant met arm
steekt overal uit : twee hendels
hoofd met verrekijker : antenne en verrekijker
driehoek bovenop : holle driehoek bovenop
opstaand juichend poppetje : trofee
platte vogel : vogel
halve kegel links : rechthoek bovenop
propellor met schijfje : ernie met piercing
bakje op mok houder : tafeltje met bakje
pinokkio neus schuinrechts : stoeptegel in achterhoofd
cocktail met citroen schijfje : cocktail of wc
bol einde armen : amsterdamse paaltjes
bolle neus ernie : ernie zijkant toblerone
serveerder dienblad rechts : dienblad
platte circle neus : mok bovenop vierkant
balletje bovenop mok : bolletje bovenop
vierkante tutu ballet : vierkante tutu slurfje
ouderwetse theepot : uitklappende kubussen rechterkant
twee linker antennes : robot
bovenop puntige driehoek : puntige driehoek bovenop
meest langwerpig : voetbaltrofee
twee balkjes rechts : stompe driehoek
meest compact : meest compact
bal midden voorkant : indiaan
opgetild bakje : tafeltje met salade bakje
doorboorde ruit bovenop : doorboorde ruit bovenop
achterkant veertje rechtsboven : spaarpot
lijkt op spagaat : spagaat
ovale bol voorkant : ei liniaal lepel
pilon omgekeerd links : dienblad omgedraaide pilon
zes ruitjes totaal : twee staartjes
lange balk voorkant : balk ervoor ei bovenop
vierkant rondom middel : glijbaan op platform
grote pluim bovenop : twee grote lepels
grote plaat rechtsvoor : robot plat vierkant
puntige driehoek bovenop : grootste driehoek bovenin
kubus rechts bovenop : cocktail
twee balken rechts : vogeltje is teken
liggende balk bovenop : meest compacte plaatje
appel steeltje naar linksboven : ei met zuignap
complex en breed : koffietafel appel steeltje poten
veel uitsteeksels overal : kraan
halve hockey puk linksboven : halve cirkel linksboven
lang handvat rechts : gieter schuin vierkant
liggend ei rechts : kegel balk ei
ronde tafel schijf rechts : biertap tafeltje
zes kleine diamantjes : clown diamantjes
bal bovenop : ei balk armen
twee : glijbaan vierkant plateau
bovenop rechtopstaand ovaal : moeilijkste bespreekbaar
verrekijker : dubbele verrekijker
puntige feesthoed : piramide hoed op wieltjes
winnaars beker : winnaars trofee
vogel met snavel : vogel
balk op bovenkant : rechthoekige hanenkam
langwerpig grote neuspiercing : neuspiercing
tafeltje op hoogte : picknick tafel
pinokkio met hoed : twee ruitjes hoed
hoekige cilinder neus : pinokkio neus
cilinder er doorheen : korte lange armen
spatel bakje met neus : lineaal en penceel
lichtinval dakraam : dienblad en dakraam
lange oren : pippi langkous oren
bal bovenop : lange kromme armen
ballerina rok : ballerina rok
olifant slurf achterkant : verrekijker
plat vierkant paddestoel : paddestoel telescoop ogen
driehoek bovenop : scherpe piramide bovenop
gedraaid voetstuk wijnglas : wijnglas
rechts twee balkjes : twee streepjes rechts
bovenop lange balk : lange balk bovenop
geknikte stok eromheen : tafel omgekeerde piramide
gebogen stukje eronder : krom uitsteeksel eronder
schijf tegen achterkant : langwerpig afgerond voetstuk
schuin vierkant erachter : armpjes bolletje uiteinde
ei neus en driehoek oor : feestneus twee haren
horizontaal schijfje rechts : bleekselderij dienblad
horizontaal vierkant eronder : vierkant horizontaal onderkant
voorkant verticale balk : verticale balk voorzijde
horizontaal vierkant doorheen : horizontaal vierkant doorsnede
twee omgekeerde kegels : rechts gestapelde blokjes
plat vierkant voorkant : paddenstoel bovenop
grote neus kuif : breder wordend vierkant
gedraaid voetstuk : schroef driehoek onderkant
twee latjes rechts : twee balkjes links
compact balk bovenop : balk en prisma's
draagt een stok : staaf door bol
tafel met bakje : tafel
een gebogen been : gebogen stukje onderaan
pan met lepel : voetstuk halve cirkel
armen met handjes : staaf er doorheen
twee verschillende haar sprieten : bol rechterkant
spijker in linkerarm : dienblad
vloer en oren : plaat onderaan
bal bovenop : balk vooraan bol
draagt een rokje : plaat midden
drie verschillende armen : kegel bovenop zijkant
twee torens links : twee torens links
pyramide bovenop : pyramide bovenop
staande voet trofee : trofee
twee rechthoeken rechts : onafgemaakte pyramide bovenop
geen enkele uitsteeksel : dun staafje voorkant
balk door balletje : hamertje
tafeltje met bakje : ontbijt op bed
voet klein blokje : boven torens vierkant
rechtsboven soort druppel : onafgemaakt plateau
uitsteeksels ronde kop : bolletjes uiteinde
balletje rechtsmidden : bolletje voorkant
omgedraaide pion : pion linksboven
staat op plateau : enige op plateau
uitsteeksel handvat links : bol bovenop
plateau in midden : plateau in midden
toren omgekeerd rechts : toren rechtsmidden
vierkant gezicht : vierkant er voor
piramide bovenop : piramide verrekijker
twister been : gedraaid been
twee rechthoeken rechts : lampenkap twee rechthoeken
lange rechthoek boven : balk boven op
punaise door bol : balk door bol
tafel voor zich : omgekeerde lampenkap dienblad
gebogen been : strik boven op
pinokkio neus links : cirkel er achter
staven met bol : springplank er achter
bol vooraan : bol twee kegels
grote spijker links : gekantelde bank spijker
cirkel voorop : diamantjes cirkel voorop
bol boven op : bol twee armpjes
twee kleine cilinders : l vorm
twee deegroller handvaten : twee roer kegels
antenne twee moertjes : robot
feesthoed dikke neus : feesthoedje
lang met driehoek : torentje
afgestompt hoedje : vogeltje
rechthoek hoed : wijze uil
jachtgeweer : dienblad
lange neus hoedje : pinokkio hanenkam
mok met lepel : gewone koffiekopje
afdakje : afdakje
ronde neus : dikke neus
toeter op neus : spijker in arm
dienblad : gehoorbescherming
waterleiding : boiler
glijbaan neus : glijbaan
kegel neus : rare armpjes
schoorsteen plaat schroeven : schoorsteentje vierkant blokken
complex driehoek raketje : driehoek raketje rondje
statief vierkant helix : helix kubus driehoek
is teken haakje trapezium : trapezium is teken boogje
compact rechthoek op veger : op veger megafoon rechthoek
ei basketbalpaal uitsteekseltje : pluimpje ei neus basketbalpaal
bankje haakje bakje : bankje bakje uitsteekseltje
ruiten schroeven uitsteeksels : ruit uisteeksels blokjes
lepeltje rond plateau : half rondje kegeltje
zonnepaneel lange staaf : gaspedaal balk lang
vulpen ei staafjes : vulpen ei neus uitsteeksels
eiffeltoren rond plateau : eiffeltoren rond plateau
kom bolletjes haakjes : vierkant plateau bolletjes
ei symmetrisch verhoging : ei hoofd gespreide armen
glijbaan vierkant omhulsel : vierkant plateau glijbaan
schroef ovale uitsteeksels : kegeltjes blokjes uitsteeksel
twee armen links : vierkant voorop
driehoek erboven : driehoek bovenop
driehoekig onder hangsel : spiraal onderin
twee armen rechts : eend
rechthoekig blokje erboven : staafje plat bovenop
blokje door bol : balk door bol
steiger voorop : tafel
uitstekende cilinder voorkant : uitsteeksel onder recht
ronde plaat achterkant : rondje achter
arm beide kanten : vierkant met steun
driehoekige arm links : twee figuren bovenop
spijker door arm : spijker
ronde schaal voorkant : onderin plateau
rechthoekige voorkant : staafje voorkant
vierkant door midden : twee kegeltjes bovenop
drie uitstekende ellipsen : twee lepels
paddenstoel op bovenkant : paddenstoel antene
piramide op bovenkant : verrekijker en piramide
standaard onder mok : driehoek spiraal voetstuk
afgesneden piramide hoed : onderzeeer
lang hoek als hoed : vloeistof afvoer
stok door clownsneus : spies door clownsneus
picknicktafel door mok : picknicktafel met mandje
ruit bovenkant mok : poot doorstoken ruit
halve cirkel achter : bovenkant halve cirkel
ballen aan hendels : piemels als handvaten
clownsneus : clownsneus
omgekeerde langwerpige pion : dienblad omgekeerde pion
pippi langkous vlechtjes : pippi langkous haren
bal op bovenkant : bal op bovenkant
tafel door midden : vierkante hoelahoep
groter wordend blokje : groter wordend vierkant
vierkante verrekijker ogen : vierkante verrekijker
verjaardags hoedje bovenop : feesthoedje bovenop
driehoekig voetje : driehoekje als voetje
twee vierkante linker oren : twee linker blok oortjes
balk liggend bovenop : liggend balkje bovenop
heel aparte neuspiercing : aparte neuspiercing
met hoog opberg plankje : picknick tafeltje met bakje
satelliet op achterhoofd : satelliet in achterhoofd
schijf half zichtbaar : afgerond langwerpig voetje
met dikke handvatten : vijzel
dikke ronde neus : staand blokje bovenop
langwerpige omhoogstekende speaker : spijker speaker
vierkante grondplaat : pippi langkous vlechtjes
bal bovenop pot : balletje bovenop
twee cylindertjes bovenop : twee cylindertjes bovenop
sambaballen links bovenop : sambaballen bovenop links
gekanteld en vierkant : schietstoel knop vierkant neuzen
puntmuts dikke neus : puntmuts dikke neus
verbogen trofee prijs : trofee schuine poot
vogel snavel rechterkant : kip snavel vleugel
dikke neus linkerkant : paaseiland oorbel mohawk
zuignap aan stok : zuignap lepel lans
kruiwagen handvaten : kruiwagen piramide
soort zuurtje bovenop : zuurtje snoeppapier slurfje
pinokkio neus cirkel : pinokkio lepel schijf
staaf bobbels doorheen : wasbord kanonnen
dikke ronde neus : twee lepels neus
spijker in neus : dienblad popnagel neus
telraam kralen zijkant : kralen weerszijde vierkant
waterpomp aan buis : pomp ei bovenop
vierkante rok slurf : tutu slurf staafjes
drie tentakels neus : tentakels vierkante neus
platte vierkant midden : schroef met vierkant
cirkel uitsteeksel linksonder : driehoek bovenop
langste figuur : schroef met kaas
twee vierkanten rechtsmidden : het is teken
twee vleugels midden : rechthoek met vleugels
gewicht heffen rechtsmidden : gewichtheffen arm
springplank bovenin rechts : sprinkplank
poppetje een been : aap klappen handen
staat op klein aansluitende ondergrond : kegel rechts
doorlopende buis midden : zonnepaneel
uitstekende bol rechtsmidden : roer pannetje soep pannetje
pijl steekt uit van linker uitsteeksel naar links boven : pijl links boven
zes ruitjes aaneen lopend : zes kraaltjes
balk langwerpig rechterkant : balk rechterkant
vierkant omringend midden : saturnus
cactus uitsteeksel boven : cactus
tank antenne scherm : paddenstoel
punt pijltje blok : kegel
schroef vierkant : trofee schroef
trechter twee strepen : wegwijsborden
kuif twee armen : klok lampenkap
olijf op stokje : olijf
statafel plateau zweven : tafel met soepkom
zeepaardje grote oren : zeepaardje
lepeltje rond koekje : pinokkio koekje
paal doorheen scherm : mri spiegel balk
ronde neus lepels : twee theelepels
spijker in arm : spijker linkerarm
kralenketting ondergrond tafeltennis : kralen
omarm paal bolletje : omarmen paal
slurf rokje oortjes : dansende olifant
drie hendels blokje : vier hendels
