schoef aan bovenkant : twee pinnen vierkant
piramide aan bovenkant : driehoek op bovenkant
rust op driehoek : staat op driehoek
afgesneden driehoek bovenkant : is teken zijkant
balk bovenop horizontaal : meest compact
kopje met lepel : bolletje met pin
tafel als plateau : balk bovenin
twee ruiten bovenkant : bovenkant doorboord vierkant
cillinder kegel rondje : ovaal voetstuk
twee cillinder bol : stok door onderkant
bol driehoek zijkant : bolletje in het midden
rond plateau vuurwerk pijl : niks bovenkant onderkant
plateau lijkt zwembad : staat op vierkant
balk naar beneden : balletje op bovenkant
twee cillinders bovenop : vierkant door midden
twee ronde kegels : piek op bovenkant
schroef platte plaat : schroeven schoorsteen vierkant
piramide : piramide
wijnglas : wijnglas
afgesneden piramide : afgezaagde driehoek
robot : scheppen aan zijkant
balk door bol : lepel rechts rondje
tafel eettafel : tafel
schaap : schaap
ovalen steun onderkant : ovaal voetstuk
zonnepaneel : zonnepaneel
bol platte balk : driehoekige balk
bijzettafeltje met tuutje : bijzettafel
zwembad : zwembad
balk voor mok : bal en balk
glijbaan : glijbaan
rechtopstaande lepel sliert : kegel boven en zijkant
verrekijker sateliet : plat vierkant voorop
punthoed wielen neus : uitstekende driehoek bovenop
rechte lijnen figuren : op gedraaid statief
motor van boot : dubbele balk rechts
raketmotoren : balk horizontaal bovenop
neus piercing : staaf door rondje
plank houder : plank snijdt middenboven
pinokkio wetenschap kunst : ruit staaf bovenop
suiker pot : pijp handvat links
rollen schuine plank : bolletje op handvaten
indiaan : ronde bal rechtsvoor
trechter kom plaat : horizontaal rondje voorop
zwembad trap afscheiding : twee kraal ketting zijkanten
balhoofd armen neus : verticale balk voorkant
glijbaan speelplaats : vierkant snijdt middenonder
theepot tol : linksvoor boven zelfde
verrekijker : verrekijker
punthoofd : puntmuts
graal beker houder : driehoek statief
deurklink : deurklink
hanenkam : hanenkam
neuspiercing : neuspiercing
bakje plank : kom houder plank
boiler : boiler
theekopje : theekopje
buis door kopje : staaf links klein
indiaan : indiaan
taart houder : taart houder
pippi langkous : pippi langkous
basketbal armpjes : basketbal
glijbaan : glijbaan
vijzel : vijzel
stapels vierkante blokjes : spijke in bovenkant
hanenkam en puntneus : driehoek aan bovenkant
trofee met blokjes : gedraaide driehoek onder
gelijk aan teken : twee balkjes rechts
vierkante staaf liggend : langwerpige balk bovenop
vierkant balletje cirkel : doorboorde bol voorkant
mengkom door tafel : tafel aan voorkant
langwerpig hexagon neus : doorboord vierkant bovenop
halve cirkel kegel : schijf aan achterkant
bolletjes twee stokken : liggend scherm achterkant
bolle neus driehoek : bol aan voorkant
spijker schuin hartje : spijker uitstekende deel
vierkante ondergrond : twee uitstekende kralensnoeren
vierkante stok vooraanzicht : bol op bovenkant
schuine cilinder vierkant : twee blokjes bovenop
kegels vierkantjes zijkant : blokjes aan voorkant
spijker scherm blokjes : spijker bovenkant blokken torentjes
hanekam vierkant cirkel : hanenkam prisma voorkant
gedraaide balk driehoek : gedraaide driehoek onder
afgekapt hoedje is teken : is teken pilon
shuttle balkje bovenop : spaceshuttle liggende balk
staaf bolletje cirkel : balk bol voorkant
tafeltje met schoteltje : tafel met bakje
doorboord vierkant glijbaan : glijbaan doorboord vierkant
blokje onderin cirkel : schijf acterkant ballon
scherm achter spijkers : liggend scherm achterkant
bolletje driehoek staafje : bol gleufje links
spijker hartje schijf : spijker in hartje
kralen vierkanten plaat : kralenketting dienblad
bolletje armen staaf : bol boven armpjes
tutu torens : twin towers tutu
ballonnetjes vierkanten blokjes : balon boven links
vierkant oog met twee schroef oren : vierkant voorkant
scherp driehoekige pet : driehoek bovenop
mogelijk mensenlijk lichaam : gedraaid uitsteeksel onderkant
pastoor achtig hoedje : is aan rechterkant
rechthoekig balk op de beker : rechthoek bovenop
appelvormig beker : vliegtuig propellor voorkant
tafel vormig pet : veel bovenkant
satelliet kop met pinokkio neus : neus en sik
oude camera toestel : lange neus staart
dikke handvaten beker : honkbalknuppel achterkant
een watermeloen neus : bolle neus
pacman oortje : rond platform rechts
symmetrische koffie beker : vierkant onderkant
hangende koffie beker : bol bovenop
een groetende robotje : twee stokjes bovenop
boomstam in beker : twee stelen
champignon kapsel robot : mushroom uitpuilende ogen
pyramide pet : driehoek met kogel
menselijke trofee : trofee
pastor met een is teken : is teken
robot stofzuigende snoepmachine : omgekeerde beker schepje
clown toeter : toeter appel blaadje
ouderwetse pistool : ak zevenenveertig
pinokkio sitcom satelliet : satteliet en sik
oude zijwaartse cameratoestel : nek halve cirkel
elektrische fiets meter : honkbalknuppel electrische fiets
onkruid schotel : misvormde waterdruppel boven
pacman helicopter landing : pacman helikopterplatform
diamanten kop koffie oren : diamantjes plat vierkant
moderne lantaarnpaal lamp : toren en bol
groetende stofzuiger robot : robot met arm
twee waterdruppels : twee druppels water
stekker robot vierkant : vierkant rechts vooraan
piramide trapezium : piramide bovenaan
pirouette armen omhoog : driehoek onderaan
kip duckface hanenkam : twee balken rechts
lampenkap schouders balk : lange balk bovenop
neuspiercing kuifje staaf : doorboord ei rechts
opgetilde plank bakje : pootjes plaat bovenaan
wijzend been omhoog : gebogen balk onderaan
basis koffie deksel : cirkel links achter
superman armen wijd : kleine eitjes weerszijden
ronde neus staartjes : los ei rechts
trechter bijzettafel reling : plat ovaal rechts
zwembad kralenketting : plaat onderaan
plank knuffel geven : ei bovenop
tutu slurf hendel : plaat doorheen voorwerp
telescoop twee hendels : meerdere blokjes rechts
robot plaat antenne : robot
piramide pipet : piramide bovenop
cocktailglas pirouette : cocktailglas
eend kip : eend
lampenkap balk : balk bovenop
doorboord ei : doorboord ei
plantenbak opgetild tafeltje : hangend aan tafeltje
ruitjes oude camera's : ruit achterkant
pannetje deksel kegel : steelpan deksel
peper zout paaseitjes : peper en zout
ei wolkenkrabber hoofd : ei voorop
b vormige reling bijzettafel : balk bijzettafeltje
clown zwembad kralenketting : clown
wolkenkrabber knuffelen : wolkenkrabber knuffel
tutu slurf hendel : tutu
oude camera kegels : twee plugs
antenne erop : robot met verrekijker
driehoekige punt erboven : piramide bovenop
op spiraal staaf : wijnglas met blokjes
twee uithangbordjes rechts : eend met staart
liggende staaf erop : kuikentje met hanenkam
viekant door bol : helikopter
bakje op plank : beker door tafel
blokjes door ruit : filter met handvaten
ronde plaat erachter : beker met pollepel
staaf bol uiteinden erdoor : deegroller door kopje
driehoekig prisma zijkant : neus en bowlingpin
rond dienblad rechts : plateau en trompet
spiraal erdoor : kopje met diamanten
balletje erop : fietsstuur met bolletje
plaat erdoor : kopje twee stokjes
blokken rechts voor : bowlingpin bovenkant zijkant
antenne blokjes plaat : verrekijker met antenne
driehoek punt blok : driehoek bovenop
trofee driehoek plateau : trofee met blokjes
uithangborden lampenkap staartje : uithangbordjes en lampenkap
balk erop vleugeltjes : balk bovenop vleugels
zuignap : bol met zuignap
tafeltje bakje : tafeltje met bakje
erachter ruit blokken : ruit toenemende vierkanten
ronde plaat erachter : rechtsbovenin pollepel
staaf bolletjes zonnescherm : zonnepaneel balk rondje
bolletje bowlingpin : bolletje aan voorkant
trompet : trompet rond plateau
drie puntjes rondje : diamanten op plateau
staaf bol armpjes : balk met bol
plaat erdoor slurf : schijf door midden
blokken rechts eruit : twee bowling pinnen
symmetrisch vierkant vlak uitsteeksel : twee torens links
puntig compact complex : tol linker kant
complex puntig lang : spiraal afvoer driehoek
hoekig afgevlakte punt : hendel links torens
symmetrisch complex puntig balk op de bovenkant twee half ronde uitsteeksel aan de zijkant : lampenkap links rechthoek
bekend rond uitsteeksel : lepel arm voorkant
puntig lang : schap met kommetje
symmetrisch puntig twee blokkige uitsteeksel bodem en rechts : afvoer onder bocht
niet symmetrisch afgevlakte onderkant cirkel aan de achterzijde : pentagon staaf links
langwerpig voorwerp dwars doorheen vlak afgerond : gieter met zonnepaneel
bolvormige object aan de voorkant twee puntige uitsteeksels een uitsteeksel aan linkerzijde : kegel bovenkant bal
puntig complex interessant : pion omgekeerd links
vlak vierkant bodem cirkel voorkant : lijn van bolletjes
langwerpig ronde form bovenkant : symetrisch bal bovenkant
complex puntig compact : reservoir plaat onderkant
kopvormig vier uitsteeksel : twee ovalen knobbels
vlak voorkant paddestoel : paddenstoel
driehoek erop : piramide rotzooi
spiraal driehoek bodem : spiraal met driehoek
handel afgevlakte driehoek : afgevlakte driekhoek hendeltje
kapjes zijkanten balk erop : rechthoek bovenkant lampenkap
balk door de bol : slinger bal cirkel
tafel mok of bakje : tafel met bakje
twee vierkanten met handels van kleinere kubussen : aangedreven vierkant slurven
cirkel achter balk erdoorheen : cirkel achterkant
cilinder achterkant twee bolletjes : achterliggende staaf knobbels
bal voorkant uitsteeksel zijkant : losse bal voorkant
mok tafeltje lang gerekte pion : pion b tafeltje
platte cirkel voorkant : kleine bolletjes plaat
bal op balk voorkant : bal bovenkant balk
slurf aan de voorkant plaat door heen : plaat met slurf
cilinder bocht achter : buis achterkant knik
robothoofd met plaat : vierkant vlak voorkant
spitse punt omhoog : driehoek bovenop uitsteeksels
getordeerd : langwerpig blokje driehoek
twee rechthoeken zijkant : twee blokken rechts
v goot : compact balkje boven
stamper door neus : ei staaf rondje
tafel met trechter : vierkant vlak hoog
zeepaardje : uitsteeksels vier zijdes
zeshoekige staaf zijkant : rondje achterkant
aanknooppunt voor boten : uitsteeksels achterkant
v goot zijkant : vier verschillend uitsteeksels
toeter op arm : langwerpig links punt
geruite handvatten : vierkant vlak onder
bal op emmer : ei bovenop staaf
emmer in vierkant : vierkant halverwege
twee ronde handvatten : twee kegels blokje
robot : robot
spitse punt : spitse driehoek bovenop
trofee : trofee wokkel
platte driehoek : platte driehoek bovenop
kip : kip
staaf door ei : staaf door bal
tafel en bakje : tafel bakje
zeepaardje : zeepaardje
zeshoekige staaf zijkant : rondje achterkant
staaf twee ballen : staaf ballen zijkant
v goot zijkant : driehoek balkje links
toeter : toeter
zes ruiten zijkanten : zes bolletjes zijkant
staaf verticaal bal : bal bovenop
vierkant midden emmer : vierkant halverwege doorheen
telescoop : telescoop
laserogen antenne : plaat spijker bovenop
voetjes snavel mohawk : driehoek bovenop
tornado onderaan : wokkel driekhoek onderaan
trapezium bovenop : twee balkjes rechts
schoonmaakrobot : lange balk bovenop
heeft een snor : kopje steel bol
rand rondom : plaat twee poten
doorboorde ruit bovenop : driehoek achter boven
kopje met citroen schijf : breed voetstuk onder
armen en matje : plaat achter kopje
pennenbak met neus : kopje lepel staaf
vastgeplakt aan kauwgom : langste spijker links
pippi langkous : kralen links rechts
korfbal korf met armen : rond bolletje bovenop
in een plaat : vierkant door figuur
links en boven dezelfde : vier verschillende uitsteeksels
links groterwordende vierkanten : antenne plaat
driehoek achterop telescoop : driehoek telescoop
wokkel met driehoek : wokkel driehoek
trapezium bovenop : trapezium
schoonmaakrobot : schoonmaakrobot
appel steeltje doorboorde neus : appel steeltje
tafel met bakje : tafel met schaaltje
vierkanten door ruiten : dubbele driehoek
cirkel achterop appel steeltje : rondje achterkant
waterval twee armen : waterval
roerstaaf voor verf : verf spatel
oude spijker plateau : oude spijker
pippi langkous : pippi staartjes
korf met bal : korfbal
platform doorboort glijbaan : glijbaan
lepel boven links : twee dezelfde lepels
telescoop ogen : rechts vierkante plaat
driehoek boven : driehoek bovenop
gedraaide onderkant : groot aanhangsel onderaan
vogeltje : twee balkjes rechts
balk boven op : rechthoekig balkje bovenop
neus met staaf : ronde neus doorboord
tafeltje met bakje : tweepotige tafel
kat : ruit bovenop
beker met roerlepel : lepeltje rechts
horizontale doorlopende staaf : linksboven soort schans
midden bovenste rij : verticale balk bovenop
spijker en plateau : rond plateau rechts
rij met ruitjes : op een plaat
balletje boven op : verticale balk zijkant
twee balkjes boven : plaat door kopje
joystick boven op : rechtop midden lepel
twee telescopen : twee telescopen
scherpe driehoek : driehoek en potloodpunt
gedraaide onderkant : groot aanhangsel blokjes
vogeltje : vogel
omgekeerd bekertje : balk omgekeerde bekers
neus doorboord : doorboorde neus kuif
tafeltje met kom : tweepotige tafel
kat : kat ruit bovenkant
beker met lepeltje : standaard en lepeltje
schans en spijker : schroef erdoor schans
neus met pennetje : neus rechthoek pen
schijfje met spijker : rond plateau rechts
macaroni : blad macaroni sprieten
bolletje ongelijke armen : bal rechthoek armen
vlak met slurf : blad door beker
telescoop met pennen : joysticks telescoop wormpje
uitschuifbare blokjes : dubbele spijker zijkant
hoge piramide : hoed aan bovenkant
omhoog gaande draaimolen : driehoek met spiraal
vogel met twee snavels : dubbele plaatjes
stofzuigende robot : balk bovenop
langwerpige neuspiercing : staaf door ei
ophang plankje : plateau met bak
bloempot op een stokje : vierkant met uitsteeksel
pinokkio : houder onderkant
centraal riolering punt : buis doorheen
dikke indiaan : bal aan zijkant
bijtelen : spijker in aanhangsel
pan vaas afwassen : plateau onderkant
bal in korfbal mandje : bal bovenop
waterglijbaan : plateau midden
twee dezelfde pluimen : ovaal midden rechtop
paddestoel kaas plakje kijkes : paddestoel bovenop
piramide koekje schroef : spijker aan zijkant
beker trofee : trofee met kubussen
hoedje vogel twee snavels : twee plaatjes zijkant
robot stofzuiger : liggende balk bovenop
neuspiercing : neus met piercing
tafeltje houder bakje : plateau met bak
klappen een standvlak : ruit met doorboren
cocktail halve cirkel : smalle houder onder
klep riool bolletjes : cilinder met plateau
indiaan omgedraaide kegel : neus zonder piercing
spijker plateau : spijker in pacman
afwas houder doorboord : plateau onderaan
korfbal houder bal : korfbal met paal
glijbaan : plateau met glijbaan
identieke pluim : zelfde uitsteeksel bovenop
stekker : horizontale torentjes paddestoel
tent : puntmuts neus oor
bier beker : scheef wijnglas blokjes
vis : snavel armpje pootje
graan machine : rechthoek bovenop
kop koffie : propellor neus sprietje
picnic tafel : tafel schaaltje dienblad
pinokkio : twee pootjes scheef
sauteer pan : wiegje handvat lepel
ernergie centrale : platte staaf courgette
indiaan clown : uitstekend rechthoek handvat
bestuuringssysteem : tafelpoot plateau uitstekend
kruk : vlechtjes neus dienblad
basketbal hoop : fietsstuur balletje basket
maal machine : stoomschip verhoogd vierkant
blender : vier uitsteeksels
robot met paddenstoel : robot champignon
tent : tipi tent
wijn glas : wijnglas speciaalbier
kuikentje : kuikentje
chicken little : chicken little
piercing : neuspiercing
tafel met bakje : tafeltje met bakje
pinokkio : dansend hobbelpaard
cocktail : cocktail citroen schijfje
courgette : courgette
neus fancy lepel : neus fancy lepel
casino royaal : casino hendel
pippi langkous : pippi langkous
basketball hoop : basketbal fietsstuur
boot met tutu : stoomboot met tutu
stofzuiger : stofzuiger
vierkant voorkant : paddestoel bovenop
piramide driehoek bovenkant : persoon met pyramide
uitsteeksel onderkant lang : schroef onderin
twee rechthoeken rechts : kip
meest compact : balk bovenop
klein uitsteeksel bovenkant : stok door neus
twee pootjes onderkant : kruiwagen
meest complex : dier op zijkant
verlengde onderkant : koffiekopje
handvaten rond uiteinde : gieter
neus en oor : ronde neus
trechtervormig uitstekend linksboven : spijker bovenop
vierkant aan onderkant : pot op vierkant
verticale rechthoek : balk en bal
vierkant door object : vierkant omheen
ovaal boven links : theepot
spijker vierkant : spijker vierkant vlak
piramide : pyramide
driekhoek onderkant : schroef op driehoek
hoedje twee rechthoeken : hoedje uitstekende puntjes
compact : compact
stokje door neus : balk door neus
kruiwagen : kruiwagen
dier : dier op zijkant
lepeltje halve circkel : kopje half rondje
schuin vierkant achterkant : gieter
neus driehoekje lepeltjes : neus twee uitsteeksels
dienblad : dienblad spijker
vierkant onder kopje : vierkant object erop
armen lange rechthoek : mannetje met armen
vierkant door midden : vierkant er doorheen
theepot : theekan
pot antenne armen : minion met verrekijker
driehoek hoedje : zeil van zeilboot
kalk trophee blokjes : typhoon
toilet spoeler staartje stekker : wiskundige vergelijking
boekentas houder boek : watermolen
gewichtheffen spring haartje : ronde neus piercing
schap hanger bloempot : trechter op salontafel
armen ster uitstekels : pinokkio met hanenkam
nek pinokkio : rond oor
gestrekte armen : diaprojector
neus antennen oor : ronde neus rechteroor
rond dienblad splinter : neus omgekeerde eiffeltoren
dienblad cirkel kopje : pippi langkous vlechten
balk bal houder : neus op hoofd
twee uitsteekseltjes : rare glijbaan
tong uit mond : mixer
antenne twee wolkenkrabbers : twee skyscrapers
piramide feesthoedje : feesthoedje
trophee : trofee
stekker afgevlakte piramide : adapter
boekentas krantenbak : kleine rugzak
neuspiercing spring haartje gewichtheffen : neuspiercing
bloempot schapje : bloembak
bliksem ruitjes : ruiten en bliksemschicht
pollepel pinokkio : cocktail
krantenbak grote rugzak : grote rugzak
ronde neus : grote neus
splinter rond plateau : naald in arm
pippi langkous onderzetter : pippi langkous
basketbalnet bal : basketbal
tabakspijp glijbaan : glijbaan
doorboord wolkenkrabbers : wolkenkrabber
vierkant aan zijkant : vierkant vlak voorkant
driehoek bovenop : driehoekige punt bovenop
staand op driehoek : wijnglas voet onderaan
twee horizontale balkjes : klein dekseltje erop
horizontaal balkje bovenop : steekt minste uit
balk door bolletje : stampot stamper aan zijkant
plateau twee schuine pootjes : bankje ertegen
gebogen balkje onderkant : twee ruiten bovenop
rond balkje links : soeplepel rechtsboven
twee bolletjes zijkanten : knobbel handvaten tegenover
ei zijkant : los paasei voorop
rond plateautje zijkant : spijker linksboven
op vierkant plateau : drie bolletjes slinger
bolletje bovenop : verticale balk voorkant
vierkant plateau halverwege : plaat erdoor heen
drie kubusjes zijkant : twee haakse handvaten
twee minecraft vierkant : twee minecraft links
driehoek bovenop : driehoek bovenop
wijnglas : wijnglas
vogeltje : eendje of vogeltje
middelvinger : middelvinger
stampot stamper : stampot stamper
bankje twee pootjes : tafeltje of bankje
ruitjes gebogen balk : minecraft op vierkantjes
voetstuk theelepel handvat : theelepeltje
twee knobbel handvatten : knobbel handvaten
ei twee uitsteeksels : ei voorop
spijker rond plateau : spijker
drie bolletjes : drie bolletjes zijkanten
verticale balk ei : vertikale balk
plateau doorheen schoorsteen : pijpje of schoorsteentje
minecraft twee handvatten : minecraft rechts
plaat verrekijker handvat : plat vierkant zijkant
feesthoed blok : driehoek bovenkant
hoog spiraal blokjes : twist naar beneden
uitlaat dakje staven : pot met kubus deksel
gootje balk jets : boek in mok
bol staaf schijf : rechterkant vastgemaakt
tafeltje bakje : soort kruk aan onderkant
dubbele plaat : hengsel aan de rechterkant
zeshoek schijf : halve maan bovenkant
vlak staven bollen : poot dwars door mok
bol gootje hendel : staaf in mok
schijf toeter : dik hengsel met twee strepen
grondvlak bolletjes : driehoekjes aan zijkant
bal balk symmetrisch : balk aan zijkant
plaat hoek buis : middenin een bierviltje
kijker hendels uitlaat : grote rechtstaande druppel
gekanteld plaat handvat : plat vierkant voorkant
feesthoed : feesthoedje bovenkant
cocktail : kronkel pizzapunt onderkant
parallele balken : parallelle staafjes zijkant
boek buisje : boek in mok
bal balk schijf : buis met schijf
tafeltje : tafelpoot onderkant
parallele platen : samengeperste vierkanten
halve maan : halve maan
honkbal knuppel : honkbalknuppel dwars doorheen
bal rare druppel : rare druppel staafje
schijf dubbel uitsteeksel : plaat zijkant
bolletjes onderplaat schijf : drie driehoekjes zijkant
bol balk handvaten : bal bovenkant hengsel
bierviltje : bierviltje om mok
twee grote druppels : grote druppel bovenkant
plat schroef torens : robot met verrekijker
hoedje en onderstel : onverklaarbare uitstulpingen alle zijden
kelk lang beker : kubussen erop driehoek eronder
vogelbekdier staartje hoeje : is aan zijkant
ruimte chip boot balk : balk erop kraan ernaast
lepel toeter : spijker door neus
tafel bakje : tafel door kom
grijper ruit gewicht : zo'n katten klok
pinokkio druppel cirkel : voetje cilinder schijf
fiets hendels vierkant deksel : kom met piemels
vulpen bol neus : hoofd achtig compas naald op hoofd
opwindbaar rond plateau : bijzettafeltje b eruit
plateau spiralen : plateau kom staartjes
bal handvaten staaf : bal erop slangen eruit
plateau staaf hendel : speeltoestel met schoorstenen
vier lange uitstulpsels : bowlingpin boven en links
robot : robot empire state ogen
potlood open kegel : holle kegel potloodpunt
kelk : kelk driehoek voet
perry het vogelbekdier : perry is teken
koffiezetapparaat ruimteschip : koffieapparaat ruimteschip flapjes
indiaan lepel toeter : indiaan toeter neus
tafel : tafel met bakje
grijper met ruit : grijphand empire state ogen
pinokkio neus cirkel lepel : pinokkio voetje achterschijf
piemels : kom piemels deksel
vulpen neus driehoek : blokje vulpen bovenop
toeter en plateau : toeter kom plateau
spiralen bogen plateau : spirelli scooter achtig plateau
fietsstuur balk bol : kom knuffelt stok
glijbaan plateau : glijbaan plaat halvewege
kegels toren flubbertje : bowlingpins slurf achterzijde
groot vierkant voor : helikopter
piramide bovenop : kabouter met puntmuts
de trofee : urinoir gedraaide afvoer
twee rechthoeken rechts : twee rechthoekige oren
liggende staaf bovenop : gebouwtje op ijsberg
paal door bolletje : neuspiercing en staart
diepe gootsteen : geweer langs hoofd
dansende pinokkio kop : stier van onderen
kopje op houdertje : waterkraan
gieter : vliegtuig met zonnepaneel
beslagkom met mixer : dartpijl in achterhoofd
omgekeerde pillon links : spijker in arm
zes kralen : kop op tafel
bal bovenop : korfbal op korf
minder diepe gootsteen : kop in tafelblad
twee uitstekende tampons : konijnenoren op onderzeeer
helikopter : helikopter
piramide : piramide of punthoed
trofee : trofee
twee rechthoeken rechts : twee rechthoeken rechts
saaie gebouw : gebouw op berg
neuspiercing : neuspiercing
geweer of gootsteen : geweer langs hoofd
pinokkio : pinokkio danst
op houdertje : kop op houder
gieter : gieter
dartpijl : dartpijl in achterhoofd
pillon : omgekeerde pilon
kralen : kralen op tafel
bal bovenop : korfbal op korf
gootsteen hendel links : ondiep door tafel
tampons : twee tampons
robot met antenne : blokjes armen
poppetje met feestmuts : driehoekig hoofd
een benig juichend poppetje : standbeeld op voet
zittend poppetje met stekels : vogel die vliegt
hoofd met hanenkam : blok op eiland
poppetje met ontstopper : appel
etende kat aan tafel : dienblad met schaal
opspringende hond : antennes als oren
steelpan met lepel : koffiekopje met wafel
gieter met handvat : pin door kopje
ronde neus hoofd : grote ronde neus
spijker arm poppetje : vangrail en dienblad
poppetje met vlechtjes : ketting
een benig rond hoofdig poppetje : bol persoon
dj langwerpige neus : pinokkio met ogen
cactus plant met uitsteeksels : kaars met armen
geblokte armen antenne : antenne en blokken
mannetje met feestmuts : feestmuts
standbeeld op statief : standbeeld
vogel met beentjes : vogeltje
recht balkje mouwtjes : blok en mouwtje
appel met stamper : appel met stampertje
schuin bakje tafel : dienblad
springend hondje : hondje
steelpannetje met lepel : steelpan
balk door lichaam : staaf en vierkant
schuine kegel rondje : kegel en balk
spijker rails rondje : spijker in vangrail
twee kralen armpjes : kraaltjes
cirkel armpjes balk : mens aan paal
langwerpige neus handje : lange neus
cactus met uitsteeksels : cactus
verrekijker met antenne : vierkant vlak rechts
driehoek bovenop : driehoek bovenop
stromend waterstraaltje : twist driehoek onderkant
stopcontact rechts : twee rechthoeken rechts
mini glijbaan links : liggende balk bovenop
neuspiercing plukje haar : balk door ei
stoel tafel bakje : trapezium op dienblad
uitsteeksel beneden rechts : staart onderkant
omgekeerde druppel ondersteuning : schijf achter bovenkant
uitsteeksels met bolletjes uiteinden : handvat links achter
bolletjes neus oor haartjes : ei midden rechts
spijker rechts plateautje : horizontale schijf rechts
kralenketting horizontaal : staat op rechthoek
mand eitjes pilaar : staande balk voorkant
links arm slurf : twee cilinders bovenop
enkele verrekijker : omgekeerde kegel bovenop
twee verrekijkers : verrekijkers
driehoek bovenop : driehoek bovenop
twirl : driehoekige voet
stekker : stekker
nikszeggend balkje bovenop : nietszeggend balk bovenop
neuspiercing : neuspiercing
tafeltje met soepkom : dienblad
olifantje : olifant
stokje links staartje : halve cirkel achterkant
theekan : theepot
neus twee antennes : rondje voor
plateau met trompet : toeter
staartjes : staartjes
paal aan voorkant : balk voorkant
slurf plaat erdoorheen : vlak door basisfiguur
een verrekijker : kegel boven zijkant
spion met verrekijker : groot vierkant aangeplakt
misvormd puntig gezicht : een driehoek boven
juichend persoon : lange poot driehoek
angry bird vogel : twee balkjes rechts
stokstijf persoon : klein balkje schuin voor
gezicht met neuspiercing : beker gezicht met neusring
kruiwagen met bakje : hoog tafeltje
robot op eenwieler : boven dubbel rechthoekig vierkant
pinokkio toilet : uitstekende cirkel achter
watergieter : gieter zonder handvat
clown ronde neus : grote ei neus
drukpers met plankje : schuine cirkel voor
drilboor met handvaten : platte rond voor
waterpomp met bal : lange balk voor
stofzuiger door grond : slurf op vierkant
stuurwiel van schepen : worm en vierkant
spion : vierkant voor
vreemde vis : afgesneden piramide neus
juichend persoon : driehoek staander beneden
angry bird : angry bird
stokstijf persoon hanekam : balkje in hand
neuspiercing : neuspiercing
kruiwagen : hoge kruiwagen
robot op eenwieler : raampjes op hoofd
pinokkio : pinokkio links neus
gieter : gieter
clown ronde neus : ei neus voor
drukpers met hendel : lange hendel linksboven
pippi langkous : pippi langkous staartjes
waterpomp met bal : open armen
stofzuiger slurf : slurf op vierkant
pier in appel : wormpje achterkant pot
verrekijker : vierkant aan voorkant
feesthoedje : soort kegel bovenkant
tulp op driehoek : vierkant bovenop
f vorm : rechts twee balkjes
pinguin : rechthoek op bovenkant
doorboorde neus : bol met rechthoek
tafel met kom : tafeltje met schaaltje
karate trap : dunne cilinder voorkant
beker met citroen schijf : links cilinder
armen en rugzak : staaf met bol
neus en vulpen : alleen bol voorkant
rond dienblad : omgekeerde kleine pion
gootsteen met ketting : vierkant als ondergrond
armen en ei : bol op bovenkant
doorgesneden pot : dikke cilinder voorkant
propellor : twee ovaalvormige cillinders
verrekijker met paddestoel : robot
feesthoed met potloodpunt : feesthoed met potlood
tulp op driehoek : tulp
f vorm : f
pinguin : vogel
doorboorde neus : doorgeboorde neus
tafel met schaaltje : tafel met schaaltje
karate trap : pinokkio neus
beker met citroen schijf : citroentje
vliegtuig vleugels rugzak : vleugels
vulpen en neus : neus en pen
omgekeerde pion : omgekeerde pion
gootsteen met kraaltjes : plateau met kraaltjes
armen en ei : ei met armpjes
doorboord snijplank slurf : slurf
propellor met staart : propellor
antenne en vierkant : vierkante plaat vooraan
boven punt driehoek : driehoek bovenop
scheve stengel wijnglas : wokkel en blokken
hoedje twee balkjes : twee blokjes rechts
vleugels vierkant bovenuit : paaltje en blokken
pilaar door bolletje : heeft een ontstopper
tafel door kopje : hoge tafel
spijker door vierkant : wasbak met kraan
potlood door kopje : ronde schijf achter
staaf door kopje : springplank achteraan
speer staaf neus : neus en antennes
spijker door arm : rond bijzettafeltje
kopje op platform : staat op vierkant
pilaar bol armpjes : bal bovenop
platform door kopje : glijbaan en haak
plantenbak vierkante arm : ronde pijp achteruit
antenne vierkant voor : vierkante plaat voor
raar blok driehoeks punt : punt bovenop
wijnglas : wijnglas
deksel twee uitsteeksels : identieke blokjes rechts
spaceship met huisje : ruimteschip en gebouw
neuspiercing : neus met piercing
tafel met kopje : tafel met bakje
wasbak doorgeprikt vierkant : wasbak met kraan
potlood cirkel lepel : ronde schijf achter
achterklep stangen : springplank achter
geen piercing hoofd : neus zonder piercing
spijker bijtafel : spijker en bijzettafel
plaat circkel sprieten : plateau en sprieten
poppetje met balk : bal bovenop
middel platform glijbaan : glijbaan en haak
vierkanten twee stengels : pijp achter
groot vierkant voorkant : robot met antenna
feestmuts en wielen : driehoek op kop
draaiend wijnglas : wijnglas
eend met uitlaat : is teken rechts
liggende balk bovenop : neus vormige neus links
staaf door ei : lepel zuignap handvat
halve tafel poten : twee potige tafel
meeste balken uitsteeksels : ruit met handvaten
ronde plaat achterkant : pinokkio
lange korte vlaggenmast : niks aan voorkant
balken voorkant ei : lepel balvormig handvat
links uitstekende nier : spijker in handvat
twee strengen vierkantjes : kop met schotel
lange balk voorkant : bal kom balk
olifanten slurf twee schoorstenen : kop door schotel
twee dichte parasols : twee deegroller handvaten
robot : robot
feestmuts : feesthoedje
wijnglas : wijnglas
is teken : flappy bird is
neus met balk : neus met balk
zuignap : zuignap
bijzet tafel poten : tafel twee poten
kraan : kraan
pinokkio : pinokkio
andere lengte uitsteeksels : twee oneven handvaten
theelepel ei neus : zuignap zonder zuignap
spijker bijzettafel : spijker bijzettafel
drie vierkantjes : vierkantjes met schotel
fietsmand : fietsmand met bal
slurf vierkant doorheen : slurf
deegrollers : deegroller en minecraft
vierkant ervoor : paddenstoeltje bovenop
puntige driehoek bovenop : puntige driehoek bovenop
driehoekige gedraaide verhoging : langwerpig kubus driehoek
twee strepen zijkant : afgevlakte driehoek bovenop
horizontale staaf bovenop : balk bovenop compact
staaf door bolletje : staaf door bolletje
horizontale plank ervoor : tafel twee pootjes
ruit bovenop : haakjes zijkant onder
halve cirkel achterkant : verborgen cirkel achter
zeshoekige staaf bolletjes : staaf door kopje
kegel staaf bovenop : bol aan voorkant
horizontale cirkel schijf : rond plateautje zijkant
diamant stengels zijkanten : op plateau staand
verticale langwerpige staaf : bol bovenop
halverwege door vierkant : vierkant door midden
groeiend vierkant voorop : afgeronde staaf bovenop
paddenstoel vorm bovenop : paddenstoel
scherpe driehoeks punt bovenop : puntig driehoek boven
gedraaide staaf onderaan : spiraal mannetje
stompe punt bovenop : vogel
horizontale balk bovenop : andere vogel
staaf door bolletje : bolletje staaf doorheen
horizontale plank ervoor : tafel twee pootjes
doorgestoken ruit bovenop : diamant bovenkant
half rondje erachter : halve cirkel achter
ovaaltjes op staaf uiteinde : gieter
volledig balletje voorop : omgekeerde kegel bovenkant
horizontale ronde schijf : horizontaal rond plateau
diamanten bovenop plaat : plateau diamantjes
verticale balk ervoor : verticale vierkante staaf
vierkant horizontaal doorheen : vierkant dwars midden
groeiend vierkant zijkant : twee pluimen
schoorsteen op kopje : twee vierkante schroeven
punt bovenop kopje : grote driehoek bovenop
driehoekig pootje : spiraal staart
rechts twee balkjes : trapezium bovenop
balkje op kopje : horizontale balk bovenop
houder met zuignap : neuspiercing bolletje
steun balkjes rondom kopje : rekje met bakje
tuitje onderaan kopje : schroef oren staart
achthoekig handvat links : rondje achter
lange horizontale staaf : twee ronde schroeven
punt staafje in kopje : pen balletje
spijker op handvat : spuit in arm
ruitjes aan weerszijden : diamanten armen ondergrond
rechthoekige poot rechts : verticale balk voorkant
vierkant snijdt kopje : plaat als rokje
drie verschillende handvaten : vier langwerpige armen
kopje met schoorsteentje : paddestoel twee schroeven
piramidedak en wijnflesje : boven piramide wijnfles
wijnglas : wijnglas driehoek statief
kluisdeur met deurklink : deurklink halve driehoek
koffie tuitje en rechthoek : koffie tuitje horizontale balk
beker met zuignap : zuignap stokje
kuipje bovenop balk : plankje met bakje
tuitje aan onderkant : onderaan tuitje ruit
ovale onderkant : ovale statief lepel
lange horizontale cilinder : twee ongelijke knoppen
twee verschillende roerstaafjes : pen rond balletje
spijker en dienblaadje : dienblad spijker arm
zes diamantjes ondergrond : diamanten staartjes
waterpomp achtig met standaard : waterpomp
glijbaan en armpje : armpje twee staafjes
drie handvaten : twee dezelfde armpjes
twee uitdijende kubussen : plat vierkant voorkant
driehoek bovenop : feesthoedje bovenop
wokkel onderaan : driehoek onderkant
twee uitstekende rechthoekjes rechts : rechts twee rechthoekjes
liggende rechthoek bovenop : horizontale staaf bovenop
mini pluimpje linksboven : staaf door bol
uitstekend tafeltje : vierhoek kubus ondersteboven
doorgestoken ruit bovenop : twee ruitjes boven
gedeeltelijke cirkel achterkant : platte schijf achter
achterzijde uitstekende klep : bolletjes aan steel
vier verschillende uitsteeksels : bol drie stekels
links uitsteeksel omhoog : horizontale schijf rechts
platte cirkel voorop : drie bolletjes zijkanten
ovaal bol bovenop : vierhoekige staaf voorkant
identieke mini staafjes bovenop : groot vierkant doormidden
uitdijende kubus rechterzijde : twee grote kegels
paddenstoel bovenop : paddestoel
driekhoek bovenop : driehoek wolkje
wokkel schroef : schroef
afgesneden piramide bovenop : rechts twee rechthoekjes
lampenkap zijkant : lampenkap
bol staaf erdoorheen : staaf door bol
tafeltje : tafel
ruiten uitstulpende kubussen : twee ruitjes
keukenmachine : keukenmachine
zout potjes : zout potjes
drie uitsteeksels en bol : bol drie stekels
toef met vierkant bovenop : platte schijf
zes dingetjes : zes bolletjes
rechthoek vooraan geplakt : rechthoekige staaf verticaal
links l vorm : l
twee identieke pluimen : boven zijkant stekel
dun rechtopstaand vierkant : twee armen
piramide bovenop : punthoofd
driehoek helemaal onderaan : ijscoupe
vierkantjes rechterzijkant : gedraaid varkentje
brede staaf bovenkant : brievenbus
zuignap koffielepel schuin : neuspiercing
dienblad bij bovenkant : kopje schapje bakje
driehoek met aanhangsel : pinokkio
smalle ronde onderkant : koekje in koffie
lijkt op gieter : fotolijstje honkbalknuppel
driehoekig uitsteeksel zijkant : kop koffie ei
oorvormig uitsteeksel zijkant : prullenbak bezem
vierkante onderzetter : twee staartjes
bol bovenop : bal kopje balk
vierkant rond midden : stekker
rechtopstaande brede koffielepel : theepot met uitsteeksel
robotarmen : robotarmen spijker
punthoed : punthoofd blok neus
ijscoupe : ijscoupe
varkentje : varkentje gedraaid
broodrooster : broodrooster
zuignap : spijker neus
dienblad bakblik : schapje poten bakje
biscuitje : ruitvormig koekje robotarmen
koffiekoekje : koekje in koffie
gieter : gieter
ei voorkant : twee lepels ei
oor : oor dienblad
spiraal vlechtjes : vlechtjes ronde neus
ei bovenop : ei kopje balk
stekkertje bovenop : stekker
slurf : vier verdeelde uitsteeksels
twee legoblokken links : verticaal vierkant voorkant
puntige piramide bovenop : driehoek achter kogel
driehoek eronder hangend : gedraaid uitsteeksel onder
afgeplatte conus bovenop : is aan zijkant
platliggende rechthoek bovenop : lang balkje bovenop
rechthoek door bol : staaf door neus
bezet plateau rechtsboven : tafeltje omgekeerde pyramide
iss achterop boven : verticaal ruit uitsteeksels
halfronde schijf bovenop : lepel plat rondje
strandstoel linksboven : zonnepaneel knuppel achter
rechthoek rechtop bovenop : bolle neus lepels
trompet linksboven : horizontaal rondje zijkant
confetti slinger erachter : drie bolletjes zijkant
bol bovenop : bol bovenop
vierkant minirokje : horizontaal snijvlak erdoorheen
legoblok rechts : handvaten bovenop zijkant
twee legoblokken links : twee lego's vierkant
piramide bovenop : pyramide kogel eend
draaiing naar driehoek : gedraaid uitsteeksel onderaan
is teken : afgekapte pyramide is
platliggend balkje bovenop : balkje bovenop
kannibaal met piercing : kannibaal inboorling piercing
plateau met pootjes : plank tafel pyramide
iss bovenop : spacestation arm onder
half rondje achterop : rondje achter kwart
honkbalknuppel met strandstoel : knuppel strandstoel zonnepaneel
kannibaal zonder piercing : neus kwast rechthoek
hartje met toeter : hartjesvorm toeter rondje
op een plateau : plateau slinger schoteltje
armpjes met bol : bol bovenop staaf
glijbaan en snijvlak : snijvlak glijbaan vierkant
regenpijp links : lego twee handvaten
blokken armpjes vierkant : vierkant blauw rond
tent trapezium cirkel : punt hoekig ovaal
taartpunt blok schroef : beker op driehoek
is tekentje hoedje pinokkio : twee rechthoeken streepje
rechthoek tuit schep : complexe voorkant
lantaarnpaal ei heft : stokje met rondjes
picknickbankje piemeltje trapezium : rechthoekig frame
pinokkio ploeg linkerarm : ruiten vierkantjes haak
pinokkio cirkel heft : hendel schijf
gieter vierkant handvat : gieter scherm schuin
vulpen lineaal ei : bak ruit
bleekselderij cirkel spijker : spijker hendel rond
platform kralen armpjes : zes rondjes boogje
omarming ei pilaar : balletje hangende bak
glijbaan hoek platform : pijp vierkant omringd
negen uur blok : ovaal veel vierkantjes
blokjes piramides spijker : spijker piramides plaat
circustent trapezium koekje : circus punt kubus
trofee : trofee voetstuk draai pilaar
is tekentje keppeltje : is teken hoedje
neus omgedraaid : driehoek staafje stokje
piercing : stokje door rondje
parkbankje : bankje pootjes bakje
ruitje blokken piramides : ruiten piramides staafje
ronde schijf hendeltje : draaischijf hendel onderstuk
gieter zonnepaneeltje : gieter staafjes scherm
vulpen pennenbakje : pen rondje tijd
bleekselderij spijker : spijker stengel plaatje
drie bolletjes : drie puntjes zijkant
knuffelaar ei : hendels balletje staaf
konijntje : pijp vierkante plaat
negen uur blokjes piramide : twee hendels piramide
paddenstoel bovenop : links en vierkant
op wielen vlieger : puntig
trofee gedraaid kubusje : uitsteeksel onder
varken links gekanteld : links boven rechts
vleugeltjes lange rechthoek : compact
doorgestoken ei : rond rechts
tafel twee stoelpoten : zwevende poten
pinokkio liggende zandloper : rechts midden onder
drankje citroen lepel : links uitstekend
ijzeren pin erdoorheen : links rechts plat
ei omgekeerde kegel : twee uitsteeksels boven
ijspegel cirkel : links hoog uitsteeksel
zwembad met trapje : symmetrisch
lange balk voorkant : langwerpige balk
linkerarm zwevend vierkant : complex
negen uur : vier uitsteeksels
paddestoel groeiende kubussen : vierkant oplopende kubussen
vlieger : vlieger
trofee : trofee
varken : varken
kip watertap : kip watertap
doorgestoken ei lepel : ei cirkel lepel
tafelpoten staartje : tafel poten cupje
groeiende kubussen armen : vierkant kubussen armen
lepel citroen : citroen lepel balk
zwaard : zwaard
ei kegel : ei omgekeerde kegel
ijspegel c : cirkel c ijspegel
symmetrisch : symmetrisch
ei armen balk : ei balk armen
glijbaan schoorsteentjes : glijbaan schoorstenen
negen uur : negen uur
robot ogen vierkant : antenne voorvlak uitsteeksels
hoedje neus oor : punthoedje vierkante blok arm
standaard vierkant driehoek : voetsteun blokken kopje
onderzeeer boot : zitten rug uitsteeksels
bootje vinnen staaf : armen neus hoofddeksel
neus piercing staaf : wc ontstopper vasthouden
tafel pootjes : tafel plateautje schaaltje
kraan sateliet : been omhoog vechtsport
lepel staaf onderkant : voetsteun uitstekende arm
staaf benen staart : lichaampje op voorgrond
neus clown : bowling pion antenne bolletjes neus
plateau draaien : dienblad antenne uitsteeksel
vierkant oren clown : ondergrond zwembad lijn zwemmen
hoofd armen neem : armen gespreid paal
rokje arm : vierkante buikband
lepel staart armen : meerdere langwerpige uitsteeksels
robot : robot
neus piramide : punthoedje dikke neus
statief beker : statief vierkantje bovenop
duikboot piramide : onderzeeer autorijden
duikboot pinnetje : onderzeeer neus met staafje
neus piercing : wc ontstopper neuspiercing
tafeltje pootjes : bureautje met pootjes
kraantje : kraantje vechtsporter
lepeltje onderkant citroen : boogschutter lepeltje armpje
deegroller staaf : deegroller
lepeltjes neus arm : ronde neus lepeltjes
bankschroef plateau : bankschroef dienblad
clown wokkels : zwembad wokkels zwembad lijn
knuffel armen staaf : omarm me
rokje vierkant : rokje vierkante buikband
mannetje lepeltje : mannetje met uitstekels
verrekijkers : torentjes gekarteld zijkant
punthoed : feestmuts puntneus oor
langwerpig : lang gedraaide standaard
vogel : twee balken rechterkant
grote neus : balk bovenop horizontaal
gootsteenontstopper : neus balk doorheen
hoge plank : vierkant bovenin eromheen
grijphaak : puntneus arm been
pinokkio : lepel halve schijf
gestrekte armen : lijkt op gieter
zijkant gezicht : liniaal penseel bal
dienblad : pylon uitstekende arm
pippi langkous : op vierkant varkensneus
basketbal : bal bovenop liggend
danseres : vierkant bijna onderin
speldenkussen : theepot rare handvaten
verrekijkers : verrekijkers antenne vierkant
punthoed : net aanrakend dingetje
langwerpig : lange voorwerp
vogel : vogeltje kuif snavel
lego poppetje : balk bovenop staafje
gootsteenontstopper door neus : ontstopper door neus
hoge plaat : vierkant twee pootjes
ruit met grijphaak : ruit arm been
pinokkio : pinokkio
armpjes : twee ronde stompjes
kegel hoofd : erop balk kegel
ober : pylon en dienblad
pippi langkous : pippi langkous varkensneus
basket : bol armpjes staaf
robot danseres : robot of ballerina
speldenkussen : wc borstels blokkendoos slurfje
paddenstoel bovenop : twee groeiende vierkanten
driehoek bovenop : driehoek bovenop
vierkant blok bovenop : gedraaide verticale balk
platte uitsteeksels rechts : uitsteeksel als is
balk bovenop : horizontale balk bovenop
bol met uitsteeksels : balk door bal
tafel er doorheen : tafeltje aan zijkant
ruit uitsteeksels bovenop : onder rechts uitsteeksel
uitstekende cilinder links : op afronde balk
uitsteeksels met bol : metsel schep aan rand
bol voorkant : pylon streep bovenuit
spijker uitsteeksel links : pacman met uitsteeksel
ligt op plateau : twee rijen bolletjes
balk rechtop voor : balk verticaal voorkant
kleine uitsteeksels boven : plateau door midden
cactus in pot : groter wordende vierkanten
torentjes en paddenstoel : twee torentjes paddestoel
tent : piramide en kogel
driehoek gedraaide balk : driehoek gedraaide balk
is teken : is platte driehoek
de compacte : compact balk boven
ding door bol : staaf door bal
picknicktafel : picknicktafel
ruit met torentjes : ruit twee torentjes
die lang duurde : ronde balk onderin
ongelijke uitstekende dingen : twee ongelijke armen
twee verschillende uitsteeksels : twee verschillende boven
spijker : spijker
drie bolletjes : drie balletjes zijkant
losstaande balk : balk ervoor
plaat er doorheen : plaat doorheen
plant in pot : plant in pot
bovenstuk van microscoop : mixer
hondenkop met feestmuts : feestmuts en toeter
een potige vogel : kampioenschaps beker
vijf vinnige vis : hoedje en pijp
hondenkop met kuif : ober
persoon met neuspiercing : mok met lepel
tweepotige mok houder : picknicktafel ervoor
dansend schaap : niet automatische handboor
urinoir met hendel : kinder ijsbeker pinguin
korte vlag houder : glijbaan
beslagkom voor eieren : twee verfkwasten
houtwerk met spijker : spijker links
complexe halsketting hanger : op platform
olifant met bolhoedje : korf
waterpomp met plateau : lange neus
olifantenhoofd met blok aanhangsel : verbaasd poppetje tong
mixer met antenne : mixer
hondenkop met feestmuts : feestmuts en toeter
kip : trofee
vijf vinnige vis : met pijp
hondenkop met kuif : ober
man met neuspiercing : neuspiercing
plateau met pootjes : afdak bovenaan
dansend schaap : dansend schaap
mok op kano koekje : op kano koekje
lucifer met mok : lucifer en plank
mok met roer spaantjes : verfkwast en spaan
houtwerk met spijker : spijker
mok met kraaltjes : op vierkant plateau
korf voor balsporten : korf
waterpomp met plateau : vierkant erdoorheen
mok met roer handvaten : wcborstel en kubusjes
plat vierkant rechterkant : twee blokken stapels links
piramide bovenop : grote driehoek boven
kubus rechts bovenop : wijnglas met blokken
trapezium bovenop midden : twee plankjes rechts
horizontale balk bovenop : liggend balkje boven
bol rechts midden : balkje door ei
horizontale plaat middenin : in tafeltje
l vorm onderkant : boogje midden onder
halve cirkel linksboven : ronde schijf achterkant
weerskanten staaf bolletjes midden : tegenovergestelde zoutvaatjes zijkant
bowlingkegel links bovenop : zijkant ei driehoek
rond plateau rechterkant : rond plateautje zijkant
plat vierkant onderop : op een vierkant
verticale balk rechts : ei boven achter
plat vierkant onder midden : in vierkant
kegel middenin bovenop : midden boven uitsteeksel
paddestoel bovenop : paddestoel bovenop
piramide bovenop : driehoek bovenop
wijnbeker : wijnglas
kip : kip
compact : compact
ei staaf erdoorheen : balk door ei
tafel twee pootjes : in tafeltje
boek twee trappetjes : boek met blokken stapels
halve cirkel bovenop : cirkel achter
twee zoutvaatjes weerskanten : zoutvaatjes
ei penseel linksboven : ei rechts
rond plateau rechts : plateautje rechts
spiraaltjes weerskanten : spiralen zijkant
verticale balk : ei bovenop
l vorm links : l links
trapje twee kegels : trappetje rechts
kubusjes vierkant zijkanten : geplakt aan muur
driehoek bovenop : scherpe punt boven
driehoekig pootje eronder : robot draaiend omhoog
twee rechthoeken rechts : deur van onderzeeer
oorbellen en hanenkam : balkje bovenop
plukje haar neuspiercing : staartje en neuspiercing
plank erdoor bovenin : bank met cakevorm
drie uitstulpsels rechtsonder : doorboord boek achter
pannetje deksel lepel : cirkel achter beker
gieter met klepje : informatiebordje achter kopje
ongelijke oren bovenop : twee lepels
spijker pacman zijtafel : spijker driekwart cilinder
plank eronder : pippi langkous staartjes
bol bovenop : basket met bal
plank erdoor onderin : in een platform
kubusjes rechter zijkant : stapel dozen rechts
muur plakker spijker kubusjes : paddenstoel groeit erop
kogel pyramide : kogel linkerkant
cocktailglas : fancy coctailglas
onderzeeer deur : deur in onderzeeer
uitlaten hanenkam neus staaf : twee uitlaten
neuspiercing plukje : plukje en neuspiercing
bankje cakevorm : bankje met cakeblik
doorboord boek handvaten : boek door pierced achter
steelpannetje lepel deksel : afgerond voetje
rare gieter : gieter met klepje
tandenborstel bakje : bakje met tandenborstels
pacman spijker zij tafeltje : spijker in pacman
paardenstaartjes plank eronder : pippi langkous staartjes
armpjes rechthoek bolletje : balk voor beker
glitch plankje slurf : glitch door vierkant
staartje uitsteeksels kubusjes : wormpje aan achterkant
paddestoel vierkant wolkenkrabbers : bril op links
piramide wiel champagnefles : piramide achter kopje
mannetje voetstuk twister : kopje op spiraal
hoedje uitlaat forklift : twee balkjes rechts
balk voetjes driehoek neus : horizontaal balkje bovenop
neuspiercing voetsteun oortje : neusring en staartje
tafel bakje pootjes : afdakje twee poten
voet ruiten arm : ruit achter kopje
kegeltje voetstuk cirkel : neus naar links
lucifers afdak ondersteuning : knuppel achter kopje
bolle neus oren : bolletje aan voorkant
b toeter tafeltje : projectie linksachter beamer
kraantjes oren ruitjes : krul links rechts
balk bol armen : verticale balk voorkant
cilinderachtige neus konijnenoren : plaat door midden
worm kegels trap : kolom boven linksvoor
verrekijker paddestoel vlak : links bril vierkant
piramide champagnefles blok : piramide bovenop
trofee voetstuk spiraal : trofee
hoedje uitlaat balken : hoedje balkjes rechts
balk voetjes voorstuk : horizontale balk bovenop
neuspiercing korfbalpaal staartje : neuspiercing
tafeltje poten bakje : tafeltje twee poten
voetje vliegtuig staart neus : vliegtuig achtervleugel ruit
voetstukje cirkel cilinder : ronde plaat achterkant
lucifers honkbalknuppels afdakje : horizontale knuppel
konijntje bol oren : konijntje bolletje voor
beamer tafeltje koker : beamer projectie
vierkant spiraal oren kraantjes : krullen links rechts
balken knuffelaar bol armen : balken knuffelaar
doorgesneden vlak oortjes : plaat doormidden
kegels pijp wolkenkrabber : uitlaat twee kegels
twee staven links : vierkant aan zijkant
halve kegel boven : puntig hoedje boven achterkant
beneden staaf driehoek : gedraaide steel onderkant
twee liggende rechthoeken : twee balkjes rechterkant
liggende rechthoek bovenop : liggende balk bovenkant
staaf door neus : steel door bol
tafel bak bovenin : staat aan tafel
vierkant staaf bovenin : twee hoekige stelen
lepel cirkel bovenin : ronde schijf achterkant
staaf links rechts : schuine plank achterkant
staaf rechthoek bovenin : losse bol voorkant
links staaf tafelpoot : rond tafeltje zijkant
midden cirkel staven : geblokte stelen zijkanten
rechthoek verticaal beneden : bol op bovenkant
plateau horizontaal midden : vierkant om midden
staaf boven links : een toren blok zijkant
tv : robot vierkant voor
tent als neus : tent als neus
spring poppetje : springen met vierkant
twee staven rechts : twee balkjes rechterkant
rechthoekige staaf bovenop : balkje op hoofd
staaf door neus : stang door neus
tafel met blok : tafeltje met bakje
spekje : spekje op hoofd
verhoging : plateautje
peper en zout : peper en zout
sims teken : sims tekentje
dienblad en tafelpoot : dienblad als neus
drie kralen : kraaltjes aan zijkanten
verticale grote staaf : balkje uitstekend beneden
rokje : rokje
blokkendoos als neus : blokkendoos als neus
vierkant voorop : magnemite sataliet
driehoek op bovenkant : robotje punthoofd blok neus
wijnglas met standaard : vogeldrinkbak fontein
vijf uitsteeksels : is teken staartje hoedje
balk op bovenkant : bel vormige arm
paal door neus : neus bot erdoorheen
hoofd met bril : picknick tafel
lange neus : pinokkio neus ruitvormige antenne
half rondje bovenkant : draaiknop hendel voetstuk
twee rondjes : dubbele hendel stuur
rondje rechtsmidden : blob neus lange veer
rechts ronde schijf : spijker platformpje rechts
staat op vierkant : draaiknop vlechtjes
rondje op bovenkant : balletje balanceren
vierkant om middel : salueren hoelahoep
vier lange uitsteeksels : hendel links uitlaatpijp
vierkant aan voorkant : vierkant vlak armpjes
wiel onderaan : robotje punthoofd blok neus
wijnglas : fontein wijnglas
is teken rechts : is teken staartje
staaf op bovenkant : balk bovenop belvormige armpjes
staaf door neus : inboorling balk door neus
picknicktafel : picknicktafel
ruit achterop : ruit in achterhoofd
smal voetstuk : halve uitstekende cirkel
scherm aan achterkant : stuur hendels scherm
verf kwastje en staaf : neus kwastje balkje
dienblad rechts : dienblad spijker
op vierkanten voetstuk : groot platform
rondje bovenop : pilaar bal bovenop
vierkant om middel : hoelahoep
vier uitsteeksels : vier uitsteeksels groeiende vierkanten
vierkant gezicht : groot vierkant oor
feesthoedje : piramide hoed
been voet : klein kubusje rechtsboven
feesthoedje zonder punt : twee oren rechterkant
omgedraaide beker oren : minste uitsteeksels
neuspiercing : neus staaf erdoor
picknicktafel op hoofd : omgekeerde halve piramide
pinokkio : omgekeerde ram
rondje op achterhoofd : pinokkio halve cirkel
twee verschillende armen : twee uitsteeksels rondjes
alleen bolle neus : ronde neus
beamer : uitstekend oor linkerkant
diamanten oren : drie kraaltjes oren
verticale neus : bolletje boven hoofd
slurfje : hoed met pijp
twee kegels snavel : uitstekende kubus rechts
vierkant op gezicht : robot
feesthoedje op hoofd : feesthoed grote snavel
been : flamingo
lijkt op stekker : stekker
balk op hoofd : balkje schepje
neuspiercing : neuspiercing
picknicktafel op hoofd : picknicktafel
twee ruiten hoofd : twee ruitjes vierkantjes
links kijkende pinokkio : pinokkio met cirkel
twee knots armen : lange korte arm
alleen ronde neus : omgekeerde kegel balk
rond dienblad : dakraam
diamanten uit oren : diamantjes
verticale neus : oma olifant knotje
slurf en tutu : olifant tutu
omgekeerde snavel : vogel omgekeerde snavel
schroef bovenkant vierkant : vierkant voorkant
puntig hoedje : driehoek bovenop
langste object voet : gedraaide staaf onder
is teken zijkant : twee strepen rechts
compact zonder uitsteeksels : langwerpige balk boven
schroef door bolletje : neus met piercing
railing zijkant pyramide : soort tafel erom
lichaam gebogen voet : kromme staaf onder
langwerpig verhoogd platform : rondje achter
armen schuin dak : soort gieter
rond bolletje zijkant : bolle neus
spijker in arm : rond platform rechts
object op platform : zes uitstekende bolletjes
poppetje balk zijkant : bolletje bovenop
twee streepjes bovenkant : lange neus vierkantje
twee ronde jongleer stokken : langwerpige punt boven
schroef in hoofd : schroef bovenop
verjaardags hoedje met punt : feesthoedje
poppetje gekromde benen : draaiende balk
half verjaardags hoedje : afgesneden punthoedje
balk bovenop hamer : moeilijke balk boven
neuspiercing : neuspiercing
spoiler tafel : tafel spoiler
mijn favoriet : ruitje oren bovenop
ronde pilaar cirkel : blok onder
diploma hoedje : gieter afstudeer hoedje
ronde neus voor : bolle neus
spijker arm : schroef in arm
clown op platform : clown
mannetje omarmt balk : bol boven
rokjes platform pijp : vierkant rond midden
diabolo's : twee diabolos
blokkentoren handvatten links : robot vierkant antenne
driehoek links bovenop kopje : eclectisch driehoek gradueel
vierkant rechtsboven rand : draai blokje driehoekje
twee staafjes rechts : gelijkheidsteken hendel voetje
rechthoekige staaf bovenop : sip hangend balkje
theelepel linksbovenin kopje : eivormig balkje traanvormig
plankje twee pootjes : plankje bakje plukje
blokkerige satelliet bovenop : ruitvormig bonenmaler uitsteeksels
lepel rechts boven : verscholen rondje voetje
steun plateau achter kopje : afgerond schuin balk
twee verschillende lepels : eivormig gleuf pijlvormig
handvat met tentharing : plateau b vormig uitsteeksel
handvaten drie balletjes : bodem golfjes circel
balletje drijft linksboven : rechthoek ei hoek
gelijke staafjes bovenop : etage hoek cilinder
drie lange handvatten : stuur handvatten slurf wolkenkrabber
twee blokken handvatten links : vierkant antenne wolkenkrabber uitsteeksels
driehoek linksboven : driehoek boven
draaikolk onderin driehoek : draai driehoekige voet
is teken rechts : twee rechthoeken rechts opzij
rechthoekig blok bovenop : sip balkje gleuf
theelepel linksboven kopje : eivormig platte cirkel
plankje poten bakje : plankje bakje erop
vierkante satelliet linksboven : gebogen tuitje onder
onderzetter koffielepel rechtsboven : voetje platte cirkel
rugsteun ongelijke handvatten : afgeronde tuitjes weerskanten
staafdiagram lepel : ei gleuf balkje
tentharing linker handvat : rond plateau voor
handvatten drie bolletjes : drie ruiten weerszijden
balletje linksbovenin kopje : eivormig rechthoek voor
gelijke staafjes bovenop : doorklieven plateau onderaan
blokken handvat rechts : twee dezelfde handvatten
verrekijker : schroef op pot
driehoek bovenaan : driehoek op pot
lijkt op wijnglas : voetstuk onder pot
bevat is teken : zijkant twee balkjes
hanenkam korte mouwen : balkje op pot
rechthoek door neus : schroef door neus
horizontale rechthoek bovenaan : bankje aan pot
een arm en been : hanekam schroef erdoor
theepot deksel linksachter : opzetstuk onder pot
vierkant bovenstuk paardenstaart : knuppel achter pot
liniaal in pennenbak : twee grotere roerstaafjes
rondvormig dienblad vasthouden : spijker in oor
pippi langkous vlechten : plaat onder pot
een bol bovenaan : balletje op pot
vierkante tutu : plaat over pot
wortelvormige neus haar : twee verschillende oren
omgekeerd hondje : hondje ondersteboven
hoedje driehoek : driehoek op hoofd
wijnglas : wijnglas
is teken : is teken
espresso apparaat : espressoapparaat
neus met staaf : spijker door neus
bankje tafeltje : bankje en duikplank
helikopter : helikopter op hoofd
theekopje met deksel : theekopje een staafje
ongelijke armen : knuppel achter pot
theemok twee lepeltjes : theekopje
dienblad en spijker : dienblad en spijker
pippi langkous : pippi langkous
bol bovenaan : balletje op pot
tutu : ballerina
uitsteeksels legoblokjes slurf : vier uitsteeksels
satelliet met antenne : kleine robot
piramide bovenop : tovenaars hoedje
gedraaid uitsteeksel onderkant : wijnglas
is teken en minteken : heuveltje bovenop
vinnen beiderzijds : weinig uitstulpingen
balletje op stokje : neuspiercing
tafel met bakje : uitklaptafeltje
satelliet vormig uitsteeksel bovenop : gespiest vierkant
mok lepel koekje : verborgen cirkel
gieter met dakje : armpjes met bolletjes
kegel rechthoek bovenin : pluim op hoofd
kegel uit pacman uitsteeksel : bleekselderij
kralensnoer op plateau : meisje met staartjes
armen en hoofd : man naast paal
glijbaan op plateau : mannetje dat zwaait
uitgerekte kubus rechts : loodrechte dildos
robot met antenne : robot
tovenaar vierkante neus : misvormde tovenaar
wijnglas gedraaide poot : wijnglas
is teken en minteken : min is teken
haaienvin met balk : balk bovenop
poppetje met neuspiercing : neuspiercing
tafeltje met bakje : tafel met kom
satelliet en staart : satteliet bovenop
kopje lepeltje rondje : verstopte cirkel
gieter met handvat : gieter
strip en zandloper uitsteeksel : uitgerekte driehoek
plateau en selderij : bleekselderij links
meisje met vlechten : meisje met vlechten
mannetje met paal : dikke man
zwaaiend met rokje : zwaaiende ballerina
twee verschillende lepels : twee lepels
verrekijker met walkie-talkie antenne : vastgeplakt vierkant zijkant
verjaardags hoedje op wieltjes : driehoek bovenop
sierlijk gedraaide voet : staand gedraaide staaf
split in oorlel : rechterkant twee rechthoekjes
pinguin met hanenkam : compact drie uitsteeksels
assymetrische dikke neus piercing : doorboorde bolle neus
platte bril : plankje met beugels
benige : doorboorde ruit bovenop
pinokkio op richel : ronde plaat achterkant
gespiest schuin afdakje : staaf ronde uiteinden
dikke bolle neus : ronde bolle neus
ober met neus toeter : linkerkant puntige spijker
symmetrisch met onderplaat : staat op viekant
gekruisigd aan paal : rechthoekige staaf zijkant
zwemmen met gebalde vuist : omsluitende viekante band
whatever pinokkio punt haar : twee omgedraaide kegels
verrekijker : verrekijker met vierkant
piramide twee wieltjes : driehoek op bovenkant
gedraaide voet : gedraaide voet
afgeplat trapezium bovenop : afgestompte driehoek
pinguin : pinguin
neuspiercing : neuspiercing
bril plankje : plankje en bril
gespiest ruit op voet : gespiest ruit
schijf achter op richel : richel
bolletjes spies plat dak : ronde bollen spies
twee stokjes complex : ronde neus sprieten
ober met spijker : ober met spijker
twee sprietjes op vierkant : staand op vierkant
knuffelende gekruisigde jezus : jezus
vierkant rokje : vierkant rokje
twee kegels verrekijker : twee kegels
twee armen controller : vierkant paddenstoel twee
driehoek hoofd : driehoek kegel trapezium
standbeeld op pilaar : kubus draai driehoek
trapeze twee balkjes : is pijl trapezium
notitie maken rechts : compact balk staafje
wc ontstopper met rondje : bol balk erdoorheen
dienblad eetbak : plank tuitje uitsteeksels
zeepaard staart oren : complex vierkanten staven
pollepel staaf rond : cirkel onderkant lepel
balk door midden : v
kom lepel bolletje : ei lepel driehoek
schroef balk dienblad : spijker cirkel b
vlechten spiegel platteau : cirkel dna ondergrond
zijkant lange balk : balk bol stang
vierkant rondom slurf : plateau buis hoek
staart armen antenne : kegels kubussen
paddestoel vierkant kubus : paddenstoel vierkant kubussen
driehoek trapeze cirkel : driehoek trapezium
wijnglas taartpunt vierkant : wijnglas draai kubus
is teken trapeze : is trapezium pijl
goudstaaf kap : compact goudstaaf kap
wc-ontstopper cirkel staaf : ei staaf cirkel
dienblad bakje : dienblad pootjes trapezium
zeepaardje ruit kubus : zeepaardje ruit staven
plateau cirkel achter : onderstel cirkel lepel
kanon staafjes ei : kanon eieren staaf
cirkel lepel staafjes : ei lepel rechthoek
spijker cirkel : spijker b cirkel
dna cirkel vierkant : dna cirkel onderstuk
ei staaf balk : ei balk staaf
zeven slurf vierkant : plateau slurf zeven
kubus staafjes slurf : kubussen lepels staaf
vierkant plateau rechts : verrekijker op hoofd
piramide bovenop : bak met feesthoedje
gedraaide balk onderaan : zwaaiend en dansend
twee balkjes rechts : koffiezetapparaat
vierkant balkje bovenop : strak gezicht
voorkant rondje balk : honden botje in bek
rechts balk driehoek : keuken plankje met bakken houder
bovenaan vierkant staaf : twee staart danseres
achterkant cirkelvormig plateau : pinokkio met haarplukje
uitstekende balken rondje : honkbal uitrusting
voorkant rechts rondje : bowl pion op hoofd
links grote spijker : dienblad vasthouden
vierkante onderzetter : chips bak met slingers
vooraan lange balk : bol.com mannetje
vierkant midden omheen : fabriek met buizen
twee ovalen staven : achteraanzicht kop miereneter
robot verrekijker : robot verrekijker
driehoek muts : punthoedje
juichen omgekeerde hond : juichende omgekeerde hond
twitter vogeltje : twitter icoontje
gezicht twee oren : gezicht met oren
neuspiercing : neuspiercing
pan doorheen gezakt : plank met pan
dansende poppetje : dansende poppetje
cocktail pinokkio : pinokkio cocktail
honkballer : honkbal uitrusting
bowlen pion : bowling pion
spijker : spijker
plateau feestslingers : tafel met slingers
bol.com man : bol.com poppetje
meisjesrok fabriek : fabriek meisje
miereneter : miereneter
spijker op mok : vierkante ogen
piramide bovenop : punthoofd
gedraaide pilaar : hoge toren
flappy bird : gelijk aan teken
dun cilindertje ernaast : raket vierkante top
spijker door bol : eivormige neus piercing
twee potig platform : tafel twee poten
negentig graden opzetstuk : vierkante spijker oren
doorboord glas ijsthee : chocomelk met wafel
ronde horizontale paal : zijwaartse peper zout
bol en uisteeksels : ei neus kegel antenne
dolk in balk : spijker in arm
wokkel oren : beker op tafel
rechte verticale paal : eihoofd dunne armen
henry stofzuiger : vierkante dwarslaesie
vier uitsteeksels : antenne drie armen
normale spijker : echte spijker
piramide : punthoofd kogel
struisvogel : wijnglas
flappy bird : flappy bird
balk : raket balk hoofd
indiaan met piercing : indiaan met piercing
tafel : tafel
doorboord boek : doorboord boek
ijsthee : ijsthee
zout en peper : peper en zout
indiaan zonder piercing : indiaan met vulpen
pacman : pacman en vergrootglas
wokkels : wokkel oren
breed : macho
glijbaan fabriek : fabriek
de moeilijke : robot moeilijk
vierkant vlak : blok achtige uitsteeksels links
driehoek : grote driehoek bovenin
schroefvorm op driehoek : gedraaide steel onder
is teken : twee rechtse uitsteeksels
soort masker : rechthoekje op kopje
bol en schijfje : stang door bolletje
soort zwevend bankje : soort picknicktafel voorkant
grootste object : ruit met armen
kom op verhoging : geribbeld uitsteeksel links
tafel in kom : afgeronde uitsteeksels beiderzijds
penseel in kom : rechthoek uit kop
soort serveerschaal : ribbel achtige en schijf uitsteeksel
kleine kubusjes : vierkante plaat onderin
lange smalle balk : bolletje boven
ronde balk : vierkant dwars doorheen
meerdere ronde handvaten : haakse bowlingpin achtige uitsteeksels
wolkenkrabbers aan kopje : wolkenkrabber ogen plat vierkant
soort tentvorm : lowlands tentje klein aanhangsel
soort cocktailglas : cocktailglas
soort is teken : is teken
robot of uiltje : robot uiltje
bolletje met stang : stang door bolletje
soort zwevend bankje : bankje bakje bovenop
wafelvorm bovenop : wafels boven
kop afgeronde balk : lepel platte schijf
tafeltje in mok : stompe armpjes tafeltje
penseel vorm : penseel bol driehoekig aanhangsel
ronde platte schijf : verkeers koontje platte schijf
vierkant met fonteintjes : fontein plat vierkanten bodem
uitstekende lange balk : kopje hoger balk
ronde lange balk : rokje armpje oogjes
kegelvormen negentig graden : negentig graden kegels
robot antenne vierkant : verrekijker en antenne
geometrisch hoedje : spitse driehoek bovenop
draaien : spiraal op driehoek
usbs staart hoedje : twee streepjes rechts
symmetrisch waterafvoer raket boosters : driehoekige neus rechts
plantenbak citroen stamper plukje : bol voorkant doorboord
tafel : tafel met blokje
ninjaster als dumbbell : ruit bovenkant doorboord
pot still oude camera : pinokkio neus links
draai emmer paneel : doorborende zeshoekige armen
puntig rond geometrisch : clownsneus driehoekig oor
kaneelstokje helicopterplatform batman signaal : toeter op arm
symmetrisch natuurlijk breed : stoom uit oren
armen plank : twee ronde armen
plat doorgezakt semi symmetrisch : twee streepjes boven
deegrol handels oude usb : vier kubussen voorkant
robot spijker plaat : verrekijker
hoedje kogel : spitse driehoek bovenop
draaiende voet : spiraal driehoekige voet
usbs staart papieren boot : usb-sticks
oorbellen balk : lage oorbellen
ijsthee stamper : ijsthee stamper
tafel : tafeltje
dumbbell ruit : doorboorde ruit bovenop
oude camera pinokkio : pinokkio
armen paneel draai emmer : zeshoekige armen
ijsthee prikker zonder ijsthee prikker : neus zonder stamper
batmanlogo kaneelstokje helicopterplatform : batman
spiralen schotel octopus arm : stoomwolkjes uit oren
dunne armen : knuffelende dunne armen
boot slang l : stoomboot met l
deegrollen : deegroller
blokkige verrekijker : joystick bovenop
grote piramide bovenop : piramide bovenop
gedraaide steunpoot : trofee
twee rechts uitstekende blokken : is teken zijkant
horizontaal rechthoek blok bovenop : houdt potlood vast
neus met paal : kopje aan zuignap
bumper driekwart hoogte : bankje
verticaal vierkanten boven : twee kromme pootjes
cirkel achter hoofd : lijkt op steelpan
horizontale buis : zonnepaneel op achtergrond
rechthoekig uitsteeksel middenboven : dikke neus voorkant
niervormig uitsteeksel links : horizontaal rondje voorkant
grote vierkante onderplaat : vierkante plaat eronder
bal bovenop : verticale paal voorkant
vierkante plaat middenhoog : in platte schijf
blokkig uitsteeksel rechts : vierkantjes toren voorkant
verrekijker vierkant : gamer
piramide bovenop : piramide bovenop
dna spiraal driehoek blok : dna streng
afgevlakte piramide bovenop : is teken zijkant
vierkante balk bovenop : potloodje
neus plus ring : inboorling
bumper piramide omgedraaid : bankje of bumper
sik : sikje
op plateau : blok
zonnepaneeltje bovenop : zonnepaneel
bolle neus : grote neus
plateau rechts : plantenbak
twee staartjes horizontaal : plaat eronder
bol bovenop : verticale paal vooraan
vierkante rok midden : tutu
vierkante kijker rechts : piraten verrekijker
ruimteschip twee motors : bliksemschicht robot vierkant
piramide bovenop : driehoek boven
troffe draaiende hendel : 3d driehoek onder
nespresso cupje bovenop : twee balkjes rechts
compact rechthoekje bovenop : ober balk cilindertje
neus met piercing : gieter hoofd
plank hoog : hoog ophang schapje links
pinokkio gek hoedje : twee gebogen balkjes
ronde deksel achterop : pinokkio cilinder links
hamer : paaltje links rechts
neus zonder piercing : cirkel omgekeerde kegel
spijker in hendel : lippen schapje kegel
op grote snijplank : diamantjes beide kanten
ei bovenop kopje : bol boven
plank door kopje : twee cilinders boven
steekt overal uit : knuppel boven rechts
ruimteschip : ruimteschip
piramide en kogel : piramide en kogel
beker : winnaars beker
kip : kip
wall-e : wall-e robot
neus met piercing : neus met piercing
schap met bakje : schapje met bakje
karate kid : karate kid
pinokkio met plukje : pinokkio met cirkel
hamer met standaard : hamer vierkant plateau
neus zonder piercing : neus zonder piercing
eiffeltoren serveerster : eiffeltoren spijker
pippi langkous : pippi langkous
omhelzing : omhelzing
olifant met arm : olifant met arm
twee hendels : joystick
hoofd met verrekijker : vierkant aan voorzijde
driehoek bovenop : holle driehoek bovenop
opstaand juichend poppetje : trofee op driehoek
platte vogel : uitkomst teken som rechterzijde
halve kegel links : rechthoek bovenop beker
propellor met schijfje : hendel bal schijf
bakje op mok houder : tafelblad twee poten
pinokkio neus schuinrechts : staaf doorboort vierkant
cocktail met citroen schijfje : toilet op ovaal
bol einde armen : pilaren weerszijden vierkant
bolle neus ernie : rechthoek pion bovenop
serveerder dienblad rechts : uitsteeksel holle cirkel
platte circle neus : vierkante ondergrond beker
balletje bovenop mok : bal bovenop
vierkante tutu ballet : vierkant halverwege beker
ouderwetse theepot : ovaal bovenop links
antenne en verrekijker : robot antenne met kubus verrekijker
holle driehoek bovenop : holle driehoek bovenop
trofee : trofee op driehoek
vogel : oplossings teken lijkt vogeltje
rechthoek bovenop : lange zijde balk
ernie met piercing : neus met piercing
tafeltje met bakje : tafel met bakje
stoeptegel in achterhoofd : dubbele stoeptegel bovenkant
cocktail of wc : cocktailglas half citroentje
amsterdamse paaltjes : verkeerspalen amsterdam zijkanten
ernie zijkant toblerone : ernie met driehoek
dienblad : dienblad met nagel
mok bovenop vierkant : vierkant diamant strook zijkanten
bolletje bovenop : balletje rechte balk
vierkante tutu slurfje : tutu met slurf
uitklappende kubussen rechterkant : slurf met kubussen
twee linker antennes : onweer en spijker
bovenop puntige driehoek : angrybirds hanekam
meest langwerpig : twister lange sokkel
twee balkjes rechts : stekker met trapezium
meest compact : hamer en drukknop
bal midden voorkant : neusbot ei veer
opgetild bakje : weegschaal wipwap bankje
doorboorde ruit bovenop : uitsteken naar buiten
achterkant veertje rechtsboven : sokkel met lepel
lijkt op spagaat : zonnepaneel doorboring staaf
ovale bol voorkant : zwevend ei lepel
pilon omgekeerd links : bijtel en platform
zes ruitjes totaal : pippi langkous plaat
lange balk voorkant : ei doorboorde tak
vierkant rondom middel : platform door mok
grote pluim bovenop : waterdruppels en onweer
robot : robot
puntige driehoek bovenop : piramide uitlopend blok
voetbaltrofee : voetbal trofee
stompe driehoek : stekker
meest compact : hamer balk bovenop
indiaan : indiaan veer neusbot
tafeltje met salade bakje : picknick tafel salade bak
doorboorde ruit bovenop : complexe figuur
spaarpot : spaarpot met lepel
spagaat : kantelscherm twee staven
ei liniaal lepel : zwevend ei lineaal
dienblad omgedraaide pilon : dienblad pylon
twee staartjes : pippi langkous
balk ervoor ei bovenop : zwevend ei balk
glijbaan op platform : waterglijbaan platform
twee grote lepels : twee grootste lepels
grote plaat rechtsvoor : vierkant rechts
puntige driehoek bovenop : piramide bovenop
kubus rechts bovenop : twee vierkanten bovenop
twee balken rechts : is rechts
liggende balk bovenop : balkje horizontaal bovenop
appel steeltje naar linksboven : ovaal met balk
complex en breed : plank omgekeerde piramide
veel uitsteeksels overal : ruit schroef bovenop
halve hockey puk linksboven : halve cirkel achterkant
lang handvat rechts : gieter vierkant achter
liggend ei rechts : ovaal rechts
ronde tafel schijf rechts : horizontale cirkel rechts
zes kleine diamantjes : bovenop een vierkant
bal bovenop : bal bovenop
twee : omringend vierkant halverwegen
bovenop rechtopstaand ovaal : rechts blokken
robot plat vierkant : de robot
grootste driehoek bovenin : groot driehoek muilkorf
cocktail : de cocktail
vogeltje is teken : is teken vogeltje
meest compacte plaatje : compact met vleugeltjes
ei met zuignap : ei balk zuignap
koffietafel appel steeltje poten : het bijzettafeltje
kraan : de kraan
halve cirkel linksboven : halve cirkel balkje
gieter schuin vierkant : de gieter
kegel balk ei : ei omgekeerde kegel
biertap tafeltje : biertap met tafeltje
clown diamantjes : de clown
ei balk armen : ei balk boogjes
glijbaan vierkant plateau : glijbaan plateau staafjes
moeilijkste bespreekbaar : de moeilijke
verrekijker : twee torens links
puntige feesthoed : punthoed
winnaars beker : gedraaide voet
vogel met snavel : is teken armpje
balk op bovenkant : rechthoekige hanenkam
langwerpig grote neuspiercing : bolletje houdt stang
tafeltje op hoogte : tafelpoten schuin trechter
pinokkio met hoed : ruit erop gewichtheffer
hoekige cilinder neus : brede smalle voet
cilinder er doorheen : stang erdoorheen breed
spatel bakje met neus : twee verschillende roerstaafjes
lichtinval dakraam : dienblad en pacman handvat
lange oren : bodemplaat met horens
bal bovenop : balletje erop
ballerina rok : door vierkant plateau
olifant slurf achterkant : twee ovalen handvatten
dubbele verrekijker : twee verrekijker torens
piramide hoed op wieltjes : punthoed piramide
winnaars trofee : trofee
vogel : vogeltje is teken
rechthoekige hanenkam : vierkante balk erop
neuspiercing : neuspiercing staaf
picknick tafel : picknicktafel met trechter
twee ruitjes hoed : ruitjes gewichtheffen
pinokkio neus : pinocchio
korte lange armen : staaf erdoorheen ongelijk
lineaal en penceel : lineaal penseel staafjes
dienblad en dakraam : dienblad en dakraam
pippi langkous oren : pippi langkous ribbels
lange kromme armen : twee dunne armpjes
ballerina rok : ballerina
verrekijker : twee ronde uitsteeksels
plat vierkant paddestoel : robot telescoop ogen
driehoek bovenop : feesthoed en kogel
gedraaid voetstuk wijnglas : wijnglas
rechts twee balkjes : afgekapt feesthoedje
bovenop lange balk : raket met loopbrug
neuspiercing : spijker door neus
geknikte stok eromheen : afdakje
gebogen stukje eronder : afvoerbuis aan onderkant
schijf tegen achterkant : cilinder bord lepel
schuin vierkant erachter : deegroller door kop
ei neus en driehoek oor : neus en meetlat
horizontaal schijfje rechts : spijker door steel
horizontaal vierkant eronder : kop met vlechten
voorkant verticale balk : dunne armpjes
horizontaal vierkant doorheen : zwaaiend
twee omgekeerde kegels : uitsteeksels alle kanten
paddestoel telescoop ogen : paddestoel twee telescopen
scherpe piramide bovenop : punthoed en kogel
wijnglas : wijnglas
twee streepjes rechts : afgekapt feesthoedje
lange balk bovenop : raket met vleugels
neuspiercing : stok door neus
tafel omgekeerde piramide : tafel door kop
krom uitsteeksel eronder : platte vierkanten boven
langwerpig afgerond voetstuk : lepel bord steelpan
armpjes bolletje uiteinde : deegroller
feestneus twee haren : ronde neus steelpan
bleekselderij dienblad : spijker door bleekselderij
vierkant horizontaal onderkant : kop met vlechten
verticale balk voorzijde : dunne armen
horizontaal vierkant doorsnede : plank door kop
rechts gestapelde blokjes : vier richtingen uitsteeksels
plat vierkant voorkant : voorin een vierkant
grote neus kuif : driehoek bovenop
gedraaid voetstuk : schroef driehoek onderin
twee latjes rechts : twee rechthoeken rechts
compact balk bovenop : links half prisma
draagt een stok : bol staaf schijf
tafel met bakje : tafeltje bakje bovenin
een gebogen been : haakje onderin
pan met lepel : omgekeerde kegel rechtsboven
armen met handjes : doorlopende staaf bol
twee verschillende haar sprieten : bol rechthoek boven
spijker in linkerarm : omgekeerde pion linksboven
vloer en oren : plateau onderin
bal bovenop : bol bovenop
draagt een rokje : twee streepjes boven
drie verschillende armen : kegel boven links
paddenstoel bovenop : paddenstoel
breder wordend vierkant : vierkant bovenop
schroef driehoek onderkant : schroef met voetstuk
twee balkjes links : twee streepjes rechts
balk en prisma's : balk bovenop
staaf door bol : bolletje balk schijf
tafel : tafel
gebogen stukje onderaan : kromme ding onderin
voetstuk halve cirkel : halve cirke
staaf er doorheen : balken schuin vlak
bol rechterkant : bol rechts
dienblad : omgekeerde pion
plaat onderaan : onderste plank
balk vooraan bol : bal bovenop
plaat midden : plank iets hoger
kegel bovenop zijkant : twee kegels
twee torens links : robot met antenne
pyramide bovenop : gezicht hanenkam wielen
staande voet trofee : voetstuk beker vlag
twee rechthoeken rechts : spijker stopcontact hoed
geen enkele uitsteeksel : simpel weinig zichtbaar
balk door balletje : arm met hamer
tafeltje met bakje : tafelblad potje zweven
voet klein blokje : kat staart onder
rechtsboven soort druppel : kook steelpan
uitsteeksels ronde kop : ding dwars erdoorheen
balletje rechtsmidden : opberg mok met neus
omgedraaide pion : kop met bekerhouder
staat op plateau : plateau met kristallen
uitsteeksel handvat links : pedalen bal op
plateau in midden : zwaaiende olifant
toren omgekeerd rechts : lange uitsteeksels
twee torens links : robot met antenne
pyramide bovenop : piramide kogel links
trofee : trofee
onafgemaakte pyramide bovenop : stompe piramide spijker
dun staafje voorkant : rechthoek boven pennetje
hamertje : hamer
ontbijt op bed : ontbijttafel met schaal
boven torens vierkant : staart pootjes kop
onafgemaakt plateau : steelpan smal plateau
bolletjes uiteinde : doorborende staaf
bolletje voorkant : gereedschaps vaas met bol
pion linksboven : pion bekerhouder
enige op plateau : drie kraaltjes
bol bovenop : bal bovenop pedalen
plateau in midden : zwaaiende olifant plateau
toren rechtsmidden : uitsteeksels omgekeerde toren
vierkant gezicht : spijker en verrekijker
piramide bovenop : piramide op kopje
twister been : wijnglas met blokjes
twee rechthoeken rechts : lampenkap op kopje
lange rechthoek boven : langwerpig blok erop
punaise door bol : balkje door neus
tafel voor zich : plank aan kopje
gebogen been : ruit aan zijkant
pinokkio neus links : enkele uitstekende cilinder
staven met bol : kopje overdwarse cilinder
bol vooraan : kegel en blok
grote spijker links : pylon aan linkerzijde
cirkel voorop : kopje op onderzetter
bol boven op : balletje op kopje
twee kleine cilinders : vierkant door kopje
twee deegroller handvaten : enkele kegel erop
vierkant er voor : spijker blokkentorens vierkant
piramide verrekijker : piramide en verrekijker
gedraaid been : glas met blokjes
lampenkap twee rechthoeken : lampenkap en balkjes
balk boven op : balk en toblerone
balk door bol : spijker door bol
omgekeerde lampenkap dienblad : dienblad met lampenkap
strik boven op : strik
cirkel er achter : cirkel aan zijkant
springplank er achter : springplank achter cilinders
bol twee kegels : twee cilinder kopje
gekantelde bank spijker : spijker in bank
diamantjes cirkel voorop : kopje met diamantjes
bol twee armpjes : balk voor mannetje
l vorm : vierkant door kopje
twee roer kegels : scheepsroer
antenne twee moertjes : vierkant oor
feesthoed dikke neus : punt hoofd
lang met driehoek : draaikolk op standaard
afgestompt hoedje : vogeltje met snavel
rechthoek hoed : leraar met stokje
neuspiercing : piercing door neus
jachtgeweer : ober die serveert
lange neus hoedje : pinokkio met arm
mok met lepel : pinokkio zonder arm
afdakje : stompe handvatten
ronde neus : rond neus
toeter op neus : spijker arm
dienblad : gekke professor
waterleiding : olifantenslurf met armen
glijbaan neus : zwembandje om middel
kegel neus : twee roerstaven
robot : de robot
feesthoedje : feesthoedje op wielen
torentje : het torentje
vogeltje : twitter vogel
wijze uil : het uiltje
neuspiercing : neus piercing
dienblad : mijn serveerder
pinokkio hanenkam : pinokkio met hanekam
gewone koffiekopje : het gewone kopje
afdakje : het afdakje
dikke neus : dikke neus
spijker in arm : jouw serveerder
gehoorbescherming : de professor
boiler : de waterleiding
glijbaan : glijbaan met band
rare armpjes : minecraft hand
schoorsteen plaat schroeven : twee blokjes balken
complex driehoek raketje : driehoek zijaanzicht gezicht
statief vierkant helix : gedraaide schroef onderaan
is teken haakje trapezium : zijaanzicht vogel
compact rechthoek op veger : compact met schuif bak
ei basketbalpaal uitsteekseltje : neus doorboord
bankje haakje bakje : plateau met bakje
ruiten schroeven uitsteeksels : balk door ruit
lepeltje rond plateau : zijaanzicht pinokkio gezicht
zonnepaneel lange staaf : buis zonder plateau
vulpen ei staafjes : hoofd met voelsprieten
eiffeltoren rond plateau : horizontaal platte cirkel
kom bolletjes haakjes : ondergrond met object
ei symmetrisch verhoging : bol op theekop
glijbaan vierkant omhulsel : plateau door object
schroef ovale uitsteeksels : bowlingkegels hoek negentig graden
schoorsteentje vierkant blokken : vierkant met schoorsteen
driehoek raketje rondje : driekhoek met bolletje
helix kubus driehoek : helix
trapezium is teken boogje : kip
op veger megafoon rechthoek : zuiger
pluimpje ei neus basketbalpaal : balk door neus
bankje bakje uitsteekseltje : bankje
ruit uisteeksels blokjes : ruit met balk
half rondje kegeltje : halve cirkel gezicht
gaspedaal balk lang : gaspedaal
vulpen ei neus uitsteeksels : hoofd met vulpen
eiffeltoren rond plateau : eifeltoren
vierkant plateau bolletjes : bolletjes op vierkant
ei hoofd gespreide armen : ei hoofd mannetje
vierkant plateau glijbaan : plateau door object
kegeltjes blokjes uitsteeksel : twee kegels
twee armen links : plat vierkant voorkant
driehoek erboven : bovenkant driehoek
driehoekig onder hangsel : op gedraaid voetstuk
twee armen rechts : afgekapte driekhoek bovenop
rechthoekig blokje erboven : balk plat bovenop
blokje door bol : balk door bol
steiger voorop : vlak met pootjes
uitstekende cilinder voorkant : plat vierkant doorboord
ronde plaat achterkant : plat ovaal achter
arm beide kanten : scheef vierkant erachter
driehoekige arm links : ronde bol voorkant
spijker door arm : ijspegel linker zijstuk
ronde schaal voorkant : drie bolletjes zijkanten
rechthoekige voorkant : verticale balk voorkant
vierkant door midden : plat vierkant midden
drie uitstekende ellipsen : boven links kegel
vierkant voorop : platte vierkant ervoor
driehoek bovenop : puntige driekhoek bovenop
spiraal onderin : gedraaid voetstuk driehoek
eend : eend
staafje plat bovenop : balk plat bovenop
balk door bol : balk door rondje
tafel : tafeltje
uitsteeksel onder recht : ingewikkelde vierkant doorboord
rondje achter : plat rondje erachter
vierkant met steun : vierkant met steuntje
twee figuren bovenop : bovenop kegel balkje
spijker : spijker in zijkant
onderin plateau : drie bolletjes zijkanten
staafje voorkant : balk ervoor
twee kegeltjes bovenop : pijpje linker zijkant
twee lepels : kegels zijkant bovenkant
paddenstoel op bovenkant : uitstekende ogen vierkant
piramide op bovenkant : driehoek pet
standaard onder mok : driehoek voetstuk vierkantjes
afgesneden piramide hoed : propellers puntig staart
lang hoek als hoed : staafje bovenop
stok door clownsneus : speer schildje in hand
picknicktafel door mok : draag rekje met bakje
ruit bovenkant mok : hoekige uitsteeksels puntneus
halve cirkel achter : roerstokje rondje staafje
ballen aan hendels : staafjes handvat vierkantje
clownsneus : roerstaafjes bolletje staafje
omgekeerde langwerpige pion : opstapje handvat schoorsteen
pippi langkous vlechtjes : vierkant voetstuk handvatten
bal op bovenkant : balkje handvatjes balletje
tafel door midden : vierkant eromheen staafjes
groter wordend blokje : armen staart punthoofd
paddenstoel antene : paddestoel hoofd vierkant
verrekijker en piramide : verrekijker piramide
driehoek spiraal voetstuk : draaiend voetstuk vierkantjes
onderzeeer : onderzeeer
vloeistof afvoer : balk hoofd afvoerputje
spies door clownsneus : clownsneus speer
picknicktafel met mandje : picknicktafel mandje
poot doorstoken ruit : een been ruit
bovenkant halve cirkel : roerstaafje plat voetstuk
piemels als handvaten : piemel mok
clownsneus : clownsneus roerstaafje kwastje
dienblad omgekeerde pion : dienblad
pippi langkous haren : pippi langkous
bal op bovenkant : bal paal stengel armen
vierkante hoelahoep : vierkante hoelahoep
groter wordend vierkant : staart uitbreidend vierkant
vierkante verrekijker ogen : vlak rechts voor
verjaardags hoedje bovenop : driehoek bovenop
driehoekig voetje : blokje rechts boven
twee vierkante linker oren : twee streepjes rechts
balk liggend bovenop : staafje liggend bovenop
heel aparte neuspiercing : cirkel stokje rechts
met hoog opberg plankje : tafeltje rechts
satelliet op achterhoofd : vierkant pootje midden
schijf half zichtbaar : lepel rechts
met dikke handvatten : vlak links boven
dikke ronde neus : rondje rechts
langwerpige omhoogstekende speaker : spijker links
vierkante grondplaat : groot vlak onder
bal bovenop pot : cirkel bovenop
twee cylindertjes bovenop : vlak rondom midden
sambaballen links bovenop : lepel recht omhoog
vierkante verrekijker : verrekijker plaat paddenstoel
feesthoedje bovenop : feesthoed rare neus
driehoekje als voetje : driehoek gedraaide poot
twee linker blok oortjes : afgeplatte feesthoed
liggend balkje bovenop : balk afzuigkap
aparte neuspiercing : neus piercing lepel
picknick tafeltje met bakje : picknickbank bak
satelliet in achterhoofd : satelliet hoofd
afgerond langwerpig voetje : zon
vijzel : vijzel
staand blokje bovenop : cirkel dakgoot pen
spijker speaker : spijker hondenbot
pippi langkous vlechtjes : pippi langkous
balletje bovenop : bal bovenop
twee cylindertjes bovenop : plaat slurf deurklink
sambaballen bovenop links : twee sambaballen
gekanteld en vierkant : televisie houder met antenne
puntmuts dikke neus : feestvarken met hoedje
verbogen trofee prijs : blij een benig poppetje
vogel snavel rechterkant : cocktailshaker
dikke neus linkerkant : rokende pinguin
zuignap aan stok : gewichts heffend koffiekopje
kruiwagen handvaten : kortpotige kopje
soort zuurtje bovenop : oordop dragend zeepaardje
pinokkio neus cirkel : opgehangen poppetje
staaf bobbels doorheen : kopje naast loopband
dikke ronde neus : kopje met lepels
spijker in neus : kopje met dienblad
telraam kralen zijkant : kopje met muizentrapjes
waterpomp aan buis : kleine boom knuffelaar
vierkante rok slurf : rokjes dragend kopje
drie tentakels neus : drie verschillende armen
schietstoel knop vierkant neuzen : verrekijker met spijker
puntmuts dikke neus : verjaardags hoed grote neus
trofee schuine poot : scheve trofee
kip snavel vleugel : zwemmende kip
paaseiland oorbel mohawk : paaseiland look-a-like
zuignap lepel lans : zuignap als speer
kruiwagen piramide : half piramide hoofd
zuurtje snoeppapier slurfje : toffee hoofd
pinokkio lepel schijf : staande pinokkio
wasbord kanonnen : kanon met wasbord
twee lepels neus : kopje met lepels
dienblad popnagel neus : dienblad
kralen weerszijde vierkant : ruit oren
pomp ei bovenop : pomp met ei
tutu slurf staafjes : tutu
tentakels vierkante neus : groter wordend vierkant
platte vierkant midden : een spijker bovenop
cirkel uitsteeksel linksonder : driehoek erop steuntje
langste figuur : schroef twee vierkantjes
twee vierkanten rechtsmidden : is gelijk aan
twee vleugels midden : liggende balk bovenop
gewicht heffen rechtsmidden : balk schijf bal
springplank bovenin rechts : soort bankje ervoor
poppetje een been : haakje eronder voorkant
staat op klein aansluitende ondergrond : cirkel erachter
doorlopende buis midden : links rechts paaltje
uitstekende bol rechtsmidden : drie verschillende staafjes
pijl steekt uit van linker uitsteeksel naar links boven : dienblad pikkel
zes ruitjes aaneen lopend : vierkant blad eronder
balk langwerpig rechterkant : bal erop balk
vierkant omringend midden : glijbaan twee sprietjes
cactus uitsteeksel boven : twee kegels
schroef met vierkant : schroef vierkant paneel
driehoek bovenop : driehoek bovenaan
schroef met kaas : schroef kaas
het is teken : is gelijk aan
rechthoek met vleugels : balk vleugels
gewichtheffen arm : gewichtheffer
sprinkplank : springplank
aap klappen handen : diertje dat klapt
kegel rechts : ondersteuning cirkel kegel
zonnepaneel : zonnepaneel schroef
roer pannetje soep pannetje : kookpotje
pijl links boven : pijl dienblad
zes kraaltjes : kraaltjes
balk rechterkant : balk rechterkant
saturnus : saturnus twee sprietjes
cactus : cactus
tank antenne scherm : paddenstoel boven vierkant
punt pijltje blok : driehoek boven cilinder
schroef vierkant : twee kubussen boven
trechter twee strepen : twee planken midden
kuif twee armen : balk boven lampenkapje
olijf op stokje : balk bal dorheen
statafel plateau zweven : tafelpoten met bakje
zeepaardje grote oren : ruit balk doorheen
lepeltje rond koekje : cilinder midden pookje
paal doorheen scherm : vierkant boven cilinder
ronde neus lepels : bol midden stekels
spijker in arm : rond plankje puntig
kralenketting ondergrond tafeltennis : ribbel cilinder aandrijfwiel
omarm paal bolletje : bol boven balk
slurf rokje oortjes : twee staafjes boven
drie hendels blokje : pook boven pook midden
paddenstoel : paddenstoel
kegel : kegel
trofee schroef : trofee
wegwijsborden : wegwijzer
klok lampenkap : klok
olijf : olijf
tafel met soepkom : tafel soepkom
zeepaardje : zeepaardje
pinokkio koekje : pinokkio
mri spiegel balk : mri scanner spiegel
twee theelepels : lepels
spijker linkerarm : spijker in arm
kralen : kralen
omarmen paal : man knuffelt paal
dansende olifant : dansende olifant
vier hendels : vier uitsteeksels
