twee pinnen vierkant : schroeven schoorsteen vierkant
driehoek op bovenkant : piramide
staat op driehoek : wijnglas
is teken zijkant : afgezaagde driehoek
meest compact : scheppen aan zijkant
bolletje met pin : lepel rechts rondje
balk bovenin : tafel
bovenkant doorboord vierkant : schaap
ovaal voetstuk : ovaal voetstuk
stok door onderkant : zonnepaneel
bolletje in het midden : driehoekige balk
niks bovenkant onderkant : bijzettafel
staat op vierkant : zwembad
balletje op bovenkant : bal en balk
vierkant door midden : glijbaan
piek op bovenkant : kegel boven en zijkant
plat vierkant voorop : verrekijker
uitstekende driehoek bovenop : puntmuts
op gedraaid statief : driehoek statief
dubbele balk rechts : deurklink
balk horizontaal bovenop : hanenkam
staaf door rondje : neuspiercing
plank snijdt middenboven : kom houder plank
ruit staaf bovenop : boiler
pijp handvat links : theekopje
bolletje op handvaten : staaf links klein
ronde bal rechtsvoor : indiaan
horizontaal rondje voorop : taart houder
twee kraal ketting zijkanten : pippi langkous
verticale balk voorkant : basketbal
vierkant snijdt middenonder : glijbaan
linksvoor boven zelfde : vijzel
spijke in bovenkant : spijker bovenkant blokken torentjes
driehoek aan bovenkant : hanenkam prisma voorkant
gedraaide driehoek onder : gedraaide driehoek onder
twee balkjes rechts : is teken pilon
langwerpige balk bovenop : spaceshuttle liggende balk
doorboorde bol voorkant : balk bol voorkant
tafel aan voorkant : tafel met bakje
doorboord vierkant bovenop : glijbaan doorboord vierkant
schijf aan achterkant : schijf acterkant ballon
liggend scherm achterkant : liggend scherm achterkant
bol aan voorkant : bol gleufje links
spijker uitstekende deel : spijker in hartje
twee uitstekende kralensnoeren : kralenketting dienblad
bol op bovenkant : bol boven armpjes
twee blokjes bovenop : twin towers tutu
blokjes aan voorkant : balon boven links
vierkant voorkant : mushroom uitpuilende ogen
driehoek bovenop : driehoek met kogel
gedraaid uitsteeksel onderkant : trofee
is aan rechterkant : is teken
rechthoek bovenop : omgekeerde beker schepje
vliegtuig propellor voorkant : toeter appel blaadje
veel bovenkant : ak zevenenveertig
neus en sik : satteliet en sik
lange neus staart : nek halve cirkel
honkbalknuppel achterkant : honkbalknuppel electrische fiets
bolle neus : misvormde waterdruppel boven
rond platform rechts : pacman helikopterplatform
vierkant onderkant : diamantjes plat vierkant
bol bovenop : toren en bol
twee stokjes bovenop : robot met arm
twee stelen : twee druppels water
vierkant rechts vooraan : robot
piramide bovenaan : piramide bovenop
driehoek onderaan : cocktailglas
twee balken rechts : eend
lange balk bovenop : balk bovenop
doorboord ei rechts : doorboord ei
pootjes plaat bovenaan : hangend aan tafeltje
gebogen balk onderaan : ruit achterkant
cirkel links achter : steelpan deksel
kleine eitjes weerszijden : peper en zout
los ei rechts : ei voorop
plat ovaal rechts : balk bijzettafeltje
plaat onderaan : clown
ei bovenop : wolkenkrabber knuffel
plaat doorheen voorwerp : tutu
meerdere blokjes rechts : twee plugs
robot met verrekijker : verrekijker met antenne
piramide bovenop : driehoek bovenop
wijnglas met blokjes : trofee met blokjes
eend met staart : uithangbordjes en lampenkap
kuikentje met hanenkam : balk bovenop vleugels
helikopter : bol met zuignap
beker door tafel : tafeltje met bakje
filter met handvaten : ruit toenemende vierkanten
beker met pollepel : rechtsbovenin pollepel
deegroller door kopje : zonnepaneel balk rondje
neus en bowlingpin : bolletje aan voorkant
plateau en trompet : trompet rond plateau
kopje met diamanten : diamanten op plateau
fietsstuur met bolletje : balk met bol
kopje twee stokjes : schijf door midden
bowlingpin bovenkant zijkant : twee bowling pinnen
twee torens links : paddenstoel
tol linker kant : piramide rotzooi
spiraal afvoer driehoek : spiraal met driehoek
hendel links torens : afgevlakte driekhoek hendeltje
lampenkap links rechthoek : rechthoek bovenkant lampenkap
lepel arm voorkant : slinger bal cirkel
schap met kommetje : tafel met bakje
afvoer onder bocht : aangedreven vierkant slurven
pentagon staaf links : cirkel achterkant
gieter met zonnepaneel : achterliggende staaf knobbels
kegel bovenkant bal : losse bal voorkant
pion omgekeerd links : pion b tafeltje
lijn van bolletjes : kleine bolletjes plaat
symetrisch bal bovenkant : bal bovenkant balk
reservoir plaat onderkant : plaat met slurf
twee ovalen knobbels : buis achterkant knik
vierkant vlak voorkant : robot
driehoek bovenop uitsteeksels : spitse driehoek bovenop
langwerpig blokje driehoek : trofee wokkel
twee blokken rechts : platte driehoek bovenop
compact balkje boven : kip
ei staaf rondje : staaf door bal
vierkant vlak hoog : tafel bakje
uitsteeksels vier zijdes : zeepaardje
rondje achterkant : rondje achterkant
uitsteeksels achterkant : staaf ballen zijkant
vier verschillend uitsteeksels : driehoek balkje links
langwerpig links punt : toeter
vierkant vlak onder : zes bolletjes zijkant
ei bovenop staaf : bal bovenop
vierkant halverwege : vierkant halverwege doorheen
twee kegels blokje : telescoop
plaat spijker bovenop : antenne plaat
driehoek bovenop : driehoek telescoop
wokkel driekhoek onderaan : wokkel driehoek
twee balkjes rechts : trapezium
lange balk bovenop : schoonmaakrobot
kopje steel bol : appel steeltje
plaat twee poten : tafel met schaaltje
driehoek achter boven : dubbele driehoek
breed voetstuk onder : rondje achterkant
plaat achter kopje : waterval
kopje lepel staaf : verf spatel
langste spijker links : oude spijker
kralen links rechts : pippi staartjes
rond bolletje bovenop : korfbal
vierkant door figuur : glijbaan
vier verschillende uitsteeksels : twee dezelfde lepels
rechts vierkante plaat : twee telescopen
driehoek bovenop : driehoek en potloodpunt
groot aanhangsel onderaan : groot aanhangsel blokjes
twee balkjes rechts : vogel
rechthoekig balkje bovenop : balk omgekeerde bekers
ronde neus doorboord : doorboorde neus kuif
tweepotige tafel : tweepotige tafel
ruit bovenop : kat ruit bovenkant
lepeltje rechts : standaard en lepeltje
linksboven soort schans : schroef erdoor schans
verticale balk bovenop : neus rechthoek pen
rond plateau rechts : rond plateau rechts
op een plaat : blad macaroni sprieten
verticale balk zijkant : bal rechthoek armen
plaat door kopje : blad door beker
rechtop midden lepel : joysticks telescoop wormpje
dubbele spijker zijkant : paddestoel bovenop
hoed aan bovenkant : spijker aan zijkant
driehoek met spiraal : trofee met kubussen
dubbele plaatjes : twee plaatjes zijkant
balk bovenop : liggende balk bovenop
staaf door ei : neus met piercing
plateau met bak : plateau met bak
vierkant met uitsteeksel : ruit met doorboren
houder onderkant : smalle houder onder
buis doorheen : cilinder met plateau
bal aan zijkant : neus zonder piercing
spijker in aanhangsel : spijker in pacman
plateau onderkant : plateau onderaan
bal bovenop : korfbal met paal
plateau midden : plateau met glijbaan
ovaal midden rechtop : zelfde uitsteeksel bovenop
horizontale torentjes paddestoel : robot champignon
puntmuts neus oor : tipi tent
scheef wijnglas blokjes : wijnglas speciaalbier
snavel armpje pootje : kuikentje
rechthoek bovenop : chicken little
propellor neus sprietje : neuspiercing
tafel schaaltje dienblad : tafeltje met bakje
twee pootjes scheef : dansend hobbelpaard
wiegje handvat lepel : cocktail citroen schijfje
platte staaf courgette : courgette
uitstekend rechthoek handvat : neus fancy lepel
tafelpoot plateau uitstekend : casino hendel
vlechtjes neus dienblad : pippi langkous
fietsstuur balletje basket : basketbal fietsstuur
stoomschip verhoogd vierkant : stoomboot met tutu
vier uitsteeksels : stofzuiger
paddestoel bovenop : spijker vierkant vlak
persoon met pyramide : pyramide
schroef onderin : schroef op driehoek
kip : hoedje uitstekende puntjes
balk bovenop : compact
stok door neus : balk door neus
kruiwagen : kruiwagen
dier op zijkant : dier op zijkant
koffiekopje : kopje half rondje
gieter : gieter
ronde neus : neus twee uitsteeksels
spijker bovenop : dienblad spijker
pot op vierkant : vierkant object erop
balk en bal : mannetje met armen
vierkant omheen : vierkant er doorheen
theepot : theekan
minion met verrekijker : twee skyscrapers
zeil van zeilboot : feesthoedje
typhoon : trofee
wiskundige vergelijking : adapter
watermolen : kleine rugzak
ronde neus piercing : neuspiercing
trechter op salontafel : bloembak
pinokkio met hanenkam : ruiten en bliksemschicht
rond oor : cocktail
diaprojector : grote rugzak
ronde neus rechteroor : grote neus
neus omgekeerde eiffeltoren : naald in arm
pippi langkous vlechten : pippi langkous
neus op hoofd : basketbal
rare glijbaan : glijbaan
mixer : wolkenkrabber
vierkant vlak voorkant : twee minecraft links
driehoekige punt bovenop : driehoek bovenop
wijnglas voet onderaan : wijnglas
klein dekseltje erop : eendje of vogeltje
steekt minste uit : middelvinger
stampot stamper aan zijkant : stampot stamper
bankje ertegen : tafeltje of bankje
twee ruiten bovenop : minecraft op vierkantjes
soeplepel rechtsboven : theelepeltje
knobbel handvaten tegenover : knobbel handvaten
los paasei voorop : ei voorop
spijker linksboven : spijker
drie bolletjes slinger : drie bolletjes zijkanten
verticale balk voorkant : vertikale balk
plaat erdoor heen : pijpje of schoorsteentje
twee haakse handvaten : minecraft rechts
plat vierkant zijkant : plat vierkant voorkant
driehoek bovenkant : feesthoedje bovenkant
twist naar beneden : kronkel pizzapunt onderkant
pot met kubus deksel : parallelle staafjes zijkant
boek in mok : boek in mok
rechterkant vastgemaakt : buis met schijf
soort kruk aan onderkant : tafelpoot onderkant
hengsel aan de rechterkant : samengeperste vierkanten
halve maan bovenkant : halve maan
poot dwars door mok : honkbalknuppel dwars doorheen
staaf in mok : rare druppel staafje
dik hengsel met twee strepen : plaat zijkant
driehoekjes aan zijkant : drie driehoekjes zijkant
balk aan zijkant : bal bovenkant hengsel
middenin een bierviltje : bierviltje om mok
grote rechtstaande druppel : grote druppel bovenkant
robot met verrekijker : robot empire state ogen
onverklaarbare uitstulpingen alle zijden : holle kegel potloodpunt
kubussen erop driehoek eronder : kelk driehoek voet
is aan zijkant : perry is teken
balk erop kraan ernaast : koffieapparaat ruimteschip flapjes
spijker door neus : indiaan toeter neus
tafel door kom : tafel met bakje
zo'n katten klok : grijphand empire state ogen
voetje cilinder schijf : pinokkio voetje achterschijf
kom met piemels : kom piemels deksel
hoofd achtig compas naald op hoofd : blokje vulpen bovenop
bijzettafeltje b eruit : toeter kom plateau
plateau kom staartjes : spirelli scooter achtig plateau
bal erop slangen eruit : kom knuffelt stok
speeltoestel met schoorstenen : glijbaan plaat halvewege
bowlingpin boven en links : bowlingpins slurf achterzijde
helikopter : helikopter
kabouter met puntmuts : piramide of punthoed
urinoir gedraaide afvoer : trofee
twee rechthoekige oren : twee rechthoeken rechts
gebouwtje op ijsberg : gebouw op berg
neuspiercing en staart : neuspiercing
geweer langs hoofd : geweer langs hoofd
stier van onderen : pinokkio danst
waterkraan : kop op houder
vliegtuig met zonnepaneel : gieter
dartpijl in achterhoofd : dartpijl in achterhoofd
spijker in arm : omgekeerde pilon
kop op tafel : kralen op tafel
korfbal op korf : korfbal op korf
kop in tafelblad : ondiep door tafel
konijnenoren op onderzeeer : twee tampons
blokjes armen : antenne en blokken
driehoekig hoofd : feestmuts
standbeeld op voet : standbeeld
vogel die vliegt : vogeltje
blok op eiland : blok en mouwtje
appel : appel met stampertje
dienblad met schaal : dienblad
antennes als oren : hondje
koffiekopje met wafel : steelpan
pin door kopje : staaf en vierkant
grote ronde neus : kegel en balk
vangrail en dienblad : spijker in vangrail
ketting : kraaltjes
bol persoon : mens aan paal
pinokkio met ogen : lange neus
kaars met armen : cactus
vierkant vlak rechts : verrekijkers
driehoek bovenop : driehoek bovenop
twist driehoek onderkant : driehoekige voet
twee rechthoeken rechts : stekker
liggende balk bovenop : nietszeggend balk bovenop
balk door ei : neuspiercing
trapezium op dienblad : dienblad
staart onderkant : olifant
schijf achter bovenkant : halve cirkel achterkant
handvat links achter : theepot
ei midden rechts : rondje voor
horizontale schijf rechts : toeter
staat op rechthoek : staartjes
staande balk voorkant : balk voorkant
twee cilinders bovenop : vlak door basisfiguur
omgekeerde kegel bovenop : kegel boven zijkant
groot vierkant aangeplakt : vierkant voor
een driehoek boven : afgesneden piramide neus
lange poot driehoek : driehoek staander beneden
twee balkjes rechts : angry bird
klein balkje schuin voor : balkje in hand
beker gezicht met neusring : neuspiercing
hoog tafeltje : hoge kruiwagen
boven dubbel rechthoekig vierkant : raampjes op hoofd
uitstekende cirkel achter : pinokkio links neus
gieter zonder handvat : gieter
grote ei neus : ei neus voor
schuine cirkel voor : lange hendel linksboven
platte rond voor : pippi langkous staartjes
lange balk voor : open armen
slurf op vierkant : slurf op vierkant
worm en vierkant : wormpje achterkant pot
vierkant aan voorkant : robot
soort kegel bovenkant : feesthoed met potlood
vierkant bovenop : tulp
rechts twee balkjes : f
rechthoek op bovenkant : vogel
bol met rechthoek : doorgeboorde neus
tafeltje met schaaltje : tafel met schaaltje
dunne cilinder voorkant : pinokkio neus
links cilinder : citroentje
staaf met bol : vleugels
alleen bol voorkant : neus en pen
omgekeerde kleine pion : omgekeerde pion
vierkant als ondergrond : plateau met kraaltjes
bol op bovenkant : ei met armpjes
dikke cilinder voorkant : slurf
twee ovaalvormige cillinders : propellor
vierkante plaat vooraan : vierkante plaat voor
driehoek bovenop : punt bovenop
wokkel en blokken : wijnglas
twee blokjes rechts : identieke blokjes rechts
paaltje en blokken : ruimteschip en gebouw
heeft een ontstopper : neus met piercing
hoge tafel : tafel met bakje
wasbak met kraan : wasbak met kraan
ronde schijf achter : ronde schijf achter
springplank achteraan : springplank achter
neus en antennes : neus zonder piercing
rond bijzettafeltje : spijker en bijzettafel
staat op vierkant : plateau en sprieten
bal bovenop : bal bovenop
glijbaan en haak : glijbaan en haak
ronde pijp achteruit : pijp achter
robot met antenna : robot
driehoek op kop : feesthoedje
wijnglas : wijnglas
is teken rechts : flappy bird is
neus vormige neus links : neus met balk
lepel zuignap handvat : zuignap
twee potige tafel : tafel twee poten
ruit met handvaten : kraan
pinokkio : pinokkio
niks aan voorkant : twee oneven handvaten
lepel balvormig handvat : zuignap zonder zuignap
spijker in handvat : spijker bijzettafel
kop met schotel : vierkantjes met schotel
bal kom balk : fietsmand met bal
kop door schotel : slurf
twee deegroller handvaten : deegroller en minecraft
paddenstoeltje bovenop : paddenstoel
puntige driehoek bovenop : puntig driehoek boven
langwerpig kubus driehoek : spiraal mannetje
afgevlakte driehoek bovenop : vogel
balk bovenop compact : andere vogel
staaf door bolletje : bolletje staaf doorheen
tafel twee pootjes : tafel twee pootjes
haakjes zijkant onder : diamant bovenkant
verborgen cirkel achter : halve cirkel achter
staaf door kopje : gieter
bol aan voorkant : omgekeerde kegel bovenkant
rond plateautje zijkant : horizontaal rond plateau
op plateau staand : plateau diamantjes
bol bovenop : verticale vierkante staaf
vierkant door midden : vierkant dwars midden
afgeronde staaf bovenop : twee pluimen
twee vierkante schroeven : paddestoel twee schroeven
grote driehoek bovenop : boven piramide wijnfles
spiraal staart : wijnglas driehoek statief
trapezium bovenop : deurklink halve driehoek
horizontale balk bovenop : koffie tuitje horizontale balk
neuspiercing bolletje : zuignap stokje
rekje met bakje : plankje met bakje
schroef oren staart : onderaan tuitje ruit
rondje achter : ovale statief lepel
twee ronde schroeven : twee ongelijke knoppen
pen balletje : pen rond balletje
spuit in arm : dienblad spijker arm
diamanten armen ondergrond : diamanten staartjes
verticale balk voorkant : waterpomp
plaat als rokje : armpje twee staafjes
vier langwerpige armen : twee dezelfde armpjes
plat vierkant voorkant : paddestoel
feesthoedje bovenop : driehoek wolkje
driehoek onderkant : schroef
rechts twee rechthoekjes : rechts twee rechthoekjes
horizontale staaf bovenop : lampenkap
staaf door bol : staaf door bol
vierhoek kubus ondersteboven : tafel
twee ruitjes boven : twee ruitjes
platte schijf achter : keukenmachine
bolletjes aan steel : zout potjes
bol drie stekels : bol drie stekels
horizontale schijf rechts : platte schijf
drie bolletjes zijkanten : zes bolletjes
vierhoekige staaf voorkant : rechthoekige staaf verticaal
groot vierkant doormidden : l
twee grote kegels : boven zijkant stekel
twee armen : robotarmen spijker
punthoofd : punthoofd blok neus
ijscoupe : ijscoupe
gedraaid varkentje : varkentje gedraaid
brievenbus : broodrooster
neuspiercing : spijker neus
kopje schapje bakje : schapje poten bakje
pinokkio : ruitvormig koekje robotarmen
koekje in koffie : koekje in koffie
fotolijstje honkbalknuppel : gieter
kop koffie ei : twee lepels ei
prullenbak bezem : oor dienblad
twee staartjes : vlechtjes ronde neus
bal kopje balk : ei kopje balk
stekker : stekker
theepot met uitsteeksel : vier verdeelde uitsteeksels
verticaal vierkant voorkant : twee lego's vierkant
driehoek achter kogel : pyramide kogel eend
gedraaid uitsteeksel onder : gedraaid uitsteeksel onderaan
is aan zijkant : afgekapte pyramide is
lang balkje bovenop : balkje bovenop
staaf door neus : kannibaal inboorling piercing
tafeltje omgekeerde pyramide : plank tafel pyramide
verticaal ruit uitsteeksels : spacestation arm onder
lepel plat rondje : rondje achter kwart
zonnepaneel knuppel achter : knuppel strandstoel zonnepaneel
bolle neus lepels : neus kwast rechthoek
horizontaal rondje zijkant : hartjesvorm toeter rondje
drie bolletjes zijkant : plateau slinger schoteltje
bol bovenop : bol bovenop staaf
horizontaal snijvlak erdoorheen : snijvlak glijbaan vierkant
handvaten bovenop zijkant : lego twee handvaten
vierkant blauw rond : spijker piramides plaat
punt hoekig ovaal : circus punt kubus
beker op driehoek : trofee voetstuk draai pilaar
twee rechthoeken streepje : is teken hoedje
complexe voorkant : driehoek staafje stokje
stokje met rondjes : stokje door rondje
rechthoekig frame : bankje pootjes bakje
ruiten vierkantjes haak : ruiten piramides staafje
hendel schijf : draaischijf hendel onderstuk
gieter scherm schuin : gieter staafjes scherm
bak ruit : pen rondje tijd
spijker hendel rond : spijker stengel plaatje
zes rondjes boogje : drie puntjes zijkant
balletje hangende bak : hendels balletje staaf
pijp vierkant omringd : pijp vierkante plaat
ovaal veel vierkantjes : twee hendels piramide
links en vierkant : vierkant oplopende kubussen
puntig : vlieger
uitsteeksel onder : trofee
links boven rechts : varken
compact : kip watertap
rond rechts : ei cirkel lepel
zwevende poten : tafel poten cupje
rechts midden onder : vierkant kubussen armen
links uitstekend : citroen lepel balk
links rechts plat : zwaard
twee uitsteeksels boven : ei omgekeerde kegel
links hoog uitsteeksel : cirkel c ijspegel
symmetrisch : symmetrisch
langwerpige balk : ei balk armen
complex : glijbaan schoorstenen
vier uitsteeksels : negen uur
antenne voorvlak uitsteeksels : robot
punthoedje vierkante blok arm : punthoedje dikke neus
voetsteun blokken kopje : statief vierkantje bovenop
zitten rug uitsteeksels : onderzeeer autorijden
armen neus hoofddeksel : onderzeeer neus met staafje
wc ontstopper vasthouden : wc ontstopper neuspiercing
tafel plateautje schaaltje : bureautje met pootjes
been omhoog vechtsport : kraantje vechtsporter
voetsteun uitstekende arm : boogschutter lepeltje armpje
lichaampje op voorgrond : deegroller
bowling pion antenne bolletjes neus : ronde neus lepeltjes
dienblad antenne uitsteeksel : bankschroef dienblad
ondergrond zwembad lijn zwemmen : zwembad wokkels zwembad lijn
armen gespreid paal : omarm me
vierkante buikband : rokje vierkante buikband
meerdere langwerpige uitsteeksels : mannetje met uitstekels
torentjes gekarteld zijkant : verrekijkers antenne vierkant
feestmuts puntneus oor : net aanrakend dingetje
lang gedraaide standaard : lange voorwerp
twee balken rechterkant : vogeltje kuif snavel
balk bovenop horizontaal : balk bovenop staafje
neus balk doorheen : ontstopper door neus
vierkant bovenin eromheen : vierkant twee pootjes
puntneus arm been : ruit arm been
lepel halve schijf : pinokkio
lijkt op gieter : twee ronde stompjes
liniaal penseel bal : erop balk kegel
pylon uitstekende arm : pylon en dienblad
op vierkant varkensneus : pippi langkous varkensneus
bal bovenop liggend : bol armpjes staaf
vierkant bijna onderin : robot of ballerina
theepot rare handvaten : wc borstels blokkendoos slurfje
twee groeiende vierkanten : twee torentjes paddestoel
driehoek bovenop : piramide en kogel
gedraaide verticale balk : driehoek gedraaide balk
uitsteeksel als is : is platte driehoek
horizontale balk bovenop : compact balk boven
balk door bal : staaf door bal
tafeltje aan zijkant : picknicktafel
onder rechts uitsteeksel : ruit twee torentjes
op afronde balk : ronde balk onderin
metsel schep aan rand : twee ongelijke armen
pylon streep bovenuit : twee verschillende boven
pacman met uitsteeksel : spijker
twee rijen bolletjes : drie balletjes zijkant
balk verticaal voorkant : balk ervoor
plateau door midden : plaat doorheen
groter wordende vierkanten : plant in pot
mixer : mixer
feestmuts en toeter : feestmuts en toeter
kampioenschaps beker : trofee
hoedje en pijp : met pijp
ober : ober
mok met lepel : neuspiercing
picknicktafel ervoor : afdak bovenaan
niet automatische handboor : dansend schaap
kinder ijsbeker pinguin : op kano koekje
glijbaan : lucifer en plank
twee verfkwasten : verfkwast en spaan
spijker links : spijker
op platform : op vierkant plateau
korf : korf
lange neus : vierkant erdoorheen
verbaasd poppetje tong : wcborstel en kubusjes
twee blokken stapels links : paddestoel bovenop
grote driehoek boven : driehoek bovenop
wijnglas met blokken : wijnglas
twee plankjes rechts : kip
liggend balkje boven : compact
balkje door ei : balk door ei
in tafeltje : in tafeltje
boogje midden onder : boek met blokken stapels
ronde schijf achterkant : cirkel achter
tegenovergestelde zoutvaatjes zijkant : zoutvaatjes
zijkant ei driehoek : ei rechts
rond plateautje zijkant : plateautje rechts
op een vierkant : spiralen zijkant
ei boven achter : ei bovenop
in vierkant : l links
midden boven uitsteeksel : trappetje rechts
geplakt aan muur : paddenstoel groeit erop
scherpe punt boven : kogel linkerkant
robot draaiend omhoog : fancy coctailglas
deur van onderzeeer : deur in onderzeeer
balkje bovenop : twee uitlaten
staartje en neuspiercing : plukje en neuspiercing
bank met cakevorm : bankje met cakeblik
doorboord boek achter : boek door pierced achter
cirkel achter beker : afgerond voetje
informatiebordje achter kopje : gieter met klepje
twee lepels : bakje met tandenborstels
spijker driekwart cilinder : spijker in pacman
pippi langkous staartjes : pippi langkous staartjes
basket met bal : balk voor beker
in een platform : glitch door vierkant
stapel dozen rechts : wormpje aan achterkant
bril op links : links bril vierkant
piramide achter kopje : piramide bovenop
kopje op spiraal : trofee
twee balkjes rechts : hoedje balkjes rechts
horizontaal balkje bovenop : horizontale balk bovenop
neusring en staartje : neuspiercing
afdakje twee poten : tafeltje twee poten
ruit achter kopje : vliegtuig achtervleugel ruit
neus naar links : ronde plaat achterkant
knuppel achter kopje : horizontale knuppel
bolletje aan voorkant : konijntje bolletje voor
projectie linksachter beamer : beamer projectie
krul links rechts : krullen links rechts
verticale balk voorkant : balken knuffelaar
plaat door midden : plaat doormidden
kolom boven linksvoor : uitlaat twee kegels
vierkant aan zijkant : robot vierkant voor
puntig hoedje boven achterkant : tent als neus
gedraaide steel onderkant : springen met vierkant
twee balkjes rechterkant : twee balkjes rechterkant
liggende balk bovenkant : balkje op hoofd
steel door bol : stang door neus
staat aan tafel : tafeltje met bakje
twee hoekige stelen : spekje op hoofd
ronde schijf achterkant : plateautje
schuine plank achterkant : peper en zout
losse bol voorkant : sims tekentje
rond tafeltje zijkant : dienblad als neus
geblokte stelen zijkanten : kraaltjes aan zijkanten
bol op bovenkant : balkje uitstekend beneden
vierkant om midden : rokje
een toren blok zijkant : blokkendoos als neus
magnemite sataliet : vierkant vlak armpjes
robotje punthoofd blok neus : robotje punthoofd blok neus
vogeldrinkbak fontein : fontein wijnglas
is teken staartje hoedje : is teken staartje
bel vormige arm : balk bovenop belvormige armpjes
neus bot erdoorheen : inboorling balk door neus
picknick tafel : picknicktafel
pinokkio neus ruitvormige antenne : ruit in achterhoofd
draaiknop hendel voetstuk : halve uitstekende cirkel
dubbele hendel stuur : stuur hendels scherm
blob neus lange veer : neus kwastje balkje
spijker platformpje rechts : dienblad spijker
draaiknop vlechtjes : groot platform
balletje balanceren : pilaar bal bovenop
salueren hoelahoep : hoelahoep
hendel links uitlaatpijp : vier uitsteeksels groeiende vierkanten
groot vierkant oor : robot
piramide hoed : feesthoed grote snavel
klein kubusje rechtsboven : flamingo
twee oren rechterkant : stekker
minste uitsteeksels : balkje schepje
neus staaf erdoor : neuspiercing
omgekeerde halve piramide : picknicktafel
omgekeerde ram : twee ruitjes vierkantjes
pinokkio halve cirkel : pinokkio met cirkel
twee uitsteeksels rondjes : lange korte arm
ronde neus : omgekeerde kegel balk
uitstekend oor linkerkant : dakraam
drie kraaltjes oren : diamantjes
bolletje boven hoofd : oma olifant knotje
hoed met pijp : olifant tutu
uitstekende kubus rechts : vogel omgekeerde snavel
vierkant voorkant : schroef bovenop
driehoek bovenop : feesthoedje
gedraaide staaf onder : draaiende balk
twee strepen rechts : afgesneden punthoedje
langwerpige balk boven : moeilijke balk boven
neus met piercing : neuspiercing
soort tafel erom : tafel spoiler
kromme staaf onder : ruitje oren bovenop
rondje achter : blok onder
soort gieter : gieter afstudeer hoedje
bolle neus : bolle neus
rond platform rechts : schroef in arm
zes uitstekende bolletjes : clown
bolletje bovenop : bol boven
lange neus vierkantje : vierkant rond midden
langwerpige punt boven : twee diabolos
robot vierkant antenne : vierkant antenne wolkenkrabber uitsteeksels
eclectisch driehoek gradueel : driehoek boven
draai blokje driehoekje : draai driehoekige voet
gelijkheidsteken hendel voetje : twee rechthoeken rechts opzij
sip hangend balkje : sip balkje gleuf
eivormig balkje traanvormig : eivormig platte cirkel
plankje bakje plukje : plankje bakje erop
ruitvormig bonenmaler uitsteeksels : gebogen tuitje onder
verscholen rondje voetje : voetje platte cirkel
afgerond schuin balk : afgeronde tuitjes weerskanten
eivormig gleuf pijlvormig : ei gleuf balkje
plateau b vormig uitsteeksel : rond plateau voor
bodem golfjes circel : drie ruiten weerszijden
rechthoek ei hoek : eivormig rechthoek voor
etage hoek cilinder : doorklieven plateau onderaan
stuur handvatten slurf wolkenkrabber : twee dezelfde handvatten
schroef op pot : hondje ondersteboven
driehoek op pot : driehoek op hoofd
voetstuk onder pot : wijnglas
zijkant twee balkjes : is teken
balkje op pot : espressoapparaat
schroef door neus : spijker door neus
bankje aan pot : bankje en duikplank
hanekam schroef erdoor : helikopter op hoofd
opzetstuk onder pot : theekopje een staafje
knuppel achter pot : knuppel achter pot
twee grotere roerstaafjes : theekopje
spijker in oor : dienblad en spijker
plaat onder pot : pippi langkous
balletje op pot : balletje op pot
plaat over pot : ballerina
twee verschillende oren : vier uitsteeksels
kleine robot : robot
tovenaars hoedje : misvormde tovenaar
heuveltje bovenop : min is teken
weinig uitstulpingen : balk bovenop
neuspiercing : neuspiercing
uitklaptafeltje : tafel met kom
gespiest vierkant : satteliet bovenop
verborgen cirkel : verstopte cirkel
armpjes met bolletjes : gieter
pluim op hoofd : uitgerekte driehoek
bleekselderij : bleekselderij links
meisje met staartjes : meisje met vlechten
man naast paal : dikke man
mannetje dat zwaait : zwaaiende ballerina
loodrechte dildos : twee lepels
vastgeplakt vierkant zijkant : verrekijker met vierkant
driehoek bovenop : driehoek op bovenkant
staand gedraaide staaf : gedraaide voet
rechterkant twee rechthoekjes : afgestompte driehoek
compact drie uitsteeksels : pinguin
doorboorde bolle neus : neuspiercing
plankje met beugels : plankje en bril
doorboorde ruit bovenop : gespiest ruit
ronde plaat achterkant : richel
staaf ronde uiteinden : ronde bollen spies
ronde bolle neus : ronde neus sprieten
linkerkant puntige spijker : ober met spijker
staat op viekant : staand op vierkant
rechthoekige staaf zijkant : jezus
omsluitende viekante band : vierkant rokje
twee omgedraaide kegels : twee kegels
vierkant paddenstoel twee : paddenstoel vierkant kubussen
driehoek kegel trapezium : driehoek trapezium
kubus draai driehoek : wijnglas draai kubus
is pijl trapezium : is trapezium pijl
compact balk staafje : compact goudstaaf kap
bol balk erdoorheen : ei staaf cirkel
plank tuitje uitsteeksels : dienblad pootjes trapezium
complex vierkanten staven : zeepaardje ruit staven
cirkel onderkant lepel : onderstel cirkel lepel
v : kanon eieren staaf
ei lepel driehoek : ei lepel rechthoek
spijker cirkel b : spijker b cirkel
cirkel dna ondergrond : dna cirkel onderstuk
balk bol stang : ei balk staaf
plateau buis hoek : plateau slurf zeven
kegels kubussen : kubussen lepels staaf
verrekijker op hoofd : robot verrekijker
bak met feesthoedje : punthoedje
zwaaiend en dansend : juichende omgekeerde hond
koffiezetapparaat : twitter icoontje
strak gezicht : gezicht met oren
honden botje in bek : neuspiercing
keuken plankje met bakken houder : plank met pan
twee staart danseres : dansende poppetje
pinokkio met haarplukje : pinokkio cocktail
honkbal uitrusting : honkbal uitrusting
bowl pion op hoofd : bowling pion
dienblad vasthouden : spijker
chips bak met slingers : tafel met slingers
bol.com mannetje : bol.com poppetje
fabriek met buizen : fabriek meisje
achteraanzicht kop miereneter : miereneter
vierkante ogen : echte spijker
punthoofd : punthoofd kogel
hoge toren : wijnglas
gelijk aan teken : flappy bird
raket vierkante top : raket balk hoofd
eivormige neus piercing : indiaan met piercing
tafel twee poten : tafel
vierkante spijker oren : doorboord boek
chocomelk met wafel : ijsthee
zijwaartse peper zout : peper en zout
ei neus kegel antenne : indiaan met vulpen
spijker in arm : pacman en vergrootglas
beker op tafel : wokkel oren
eihoofd dunne armen : macho
vierkante dwarslaesie : fabriek
antenne drie armen : robot moeilijk
blok achtige uitsteeksels links : wolkenkrabber ogen plat vierkant
grote driehoek bovenin : lowlands tentje klein aanhangsel
gedraaide steel onder : cocktailglas
twee rechtse uitsteeksels : is teken
rechthoekje op kopje : robot uiltje
stang door bolletje : stang door bolletje
soort picknicktafel voorkant : bankje bakje bovenop
ruit met armen : wafels boven
geribbeld uitsteeksel links : lepel platte schijf
afgeronde uitsteeksels beiderzijds : stompe armpjes tafeltje
rechthoek uit kop : penseel bol driehoekig aanhangsel
ribbel achtige en schijf uitsteeksel : verkeers koontje platte schijf
vierkante plaat onderin : fontein plat vierkanten bodem
bolletje boven : kopje hoger balk
vierkant dwars doorheen : rokje armpje oogjes
haakse bowlingpin achtige uitsteeksels : negentig graden kegels
verrekijker en antenne : verrekijker
spitse driehoek bovenop : spitse driehoek bovenop
spiraal op driehoek : spiraal driehoekige voet
twee streepjes rechts : usb-sticks
driehoekige neus rechts : lage oorbellen
bol voorkant doorboord : ijsthee stamper
tafel met blokje : tafeltje
ruit bovenkant doorboord : doorboorde ruit bovenop
pinokkio neus links : pinokkio
doorborende zeshoekige armen : zeshoekige armen
clownsneus driehoekig oor : neus zonder stamper
toeter op arm : batman
stoom uit oren : stoomwolkjes uit oren
twee ronde armen : knuffelende dunne armen
twee streepjes boven : stoomboot met l
vier kubussen voorkant : deegroller
joystick bovenop : gamer
piramide bovenop : piramide bovenop
trofee : dna streng
is teken zijkant : is teken zijkant
houdt potlood vast : potloodje
kopje aan zuignap : inboorling
bankje : bankje of bumper
twee kromme pootjes : sikje
lijkt op steelpan : blok
zonnepaneel op achtergrond : zonnepaneel
dikke neus voorkant : grote neus
horizontaal rondje voorkant : plantenbak
vierkante plaat eronder : plaat eronder
verticale paal voorkant : verticale paal vooraan
in platte schijf : tutu
vierkantjes toren voorkant : piraten verrekijker
bliksemschicht robot vierkant : ruimteschip
driehoek boven : piramide en kogel
3d driehoek onder : winnaars beker
twee balkjes rechts : kip
ober balk cilindertje : wall-e robot
gieter hoofd : neus met piercing
hoog ophang schapje links : schapje met bakje
twee gebogen balkjes : karate kid
pinokkio cilinder links : pinokkio met cirkel
paaltje links rechts : hamer vierkant plateau
cirkel omgekeerde kegel : neus zonder piercing
lippen schapje kegel : eiffeltoren spijker
diamantjes beide kanten : pippi langkous
bol boven : omhelzing
twee cilinders boven : olifant met arm
knuppel boven rechts : joystick
vierkant aan voorzijde : robot antenne met kubus verrekijker
holle driehoek bovenop : holle driehoek bovenop
trofee op driehoek : trofee op driehoek
uitkomst teken som rechterzijde : oplossings teken lijkt vogeltje
rechthoek bovenop beker : lange zijde balk
hendel bal schijf : neus met piercing
tafelblad twee poten : tafel met bakje
staaf doorboort vierkant : dubbele stoeptegel bovenkant
toilet op ovaal : cocktailglas half citroentje
pilaren weerszijden vierkant : verkeerspalen amsterdam zijkanten
rechthoek pion bovenop : ernie met driehoek
uitsteeksel holle cirkel : dienblad met nagel
vierkante ondergrond beker : vierkant diamant strook zijkanten
bal bovenop : balletje rechte balk
vierkant halverwege beker : tutu met slurf
ovaal bovenop links : slurf met kubussen
onweer en spijker : robot
angrybirds hanekam : piramide uitlopend blok
twister lange sokkel : voetbal trofee
stekker met trapezium : stekker
hamer en drukknop : hamer balk bovenop
neusbot ei veer : indiaan veer neusbot
weegschaal wipwap bankje : picknick tafel salade bak
uitsteken naar buiten : complexe figuur
sokkel met lepel : spaarpot met lepel
zonnepaneel doorboring staaf : kantelscherm twee staven
zwevend ei lepel : zwevend ei lineaal
bijtel en platform : dienblad pylon
pippi langkous plaat : pippi langkous
ei doorboorde tak : zwevend ei balk
platform door mok : waterglijbaan platform
waterdruppels en onweer : twee grootste lepels
vierkant rechts : de robot
piramide bovenop : groot driehoek muilkorf
twee vierkanten bovenop : de cocktail
is rechts : is teken vogeltje
balkje horizontaal bovenop : compact met vleugeltjes
ovaal met balk : ei balk zuignap
plank omgekeerde piramide : het bijzettafeltje
ruit schroef bovenop : de kraan
halve cirkel achterkant : halve cirkel balkje
gieter vierkant achter : de gieter
ovaal rechts : ei omgekeerde kegel
horizontale cirkel rechts : biertap met tafeltje
bovenop een vierkant : de clown
bal bovenop : ei balk boogjes
omringend vierkant halverwegen : glijbaan plateau staafjes
rechts blokken : de moeilijke
twee torens links : twee verrekijker torens
punthoed : punthoed piramide
gedraaide voet : trofee
is teken armpje : vogeltje is teken
rechthoekige hanenkam : vierkante balk erop
bolletje houdt stang : neuspiercing staaf
tafelpoten schuin trechter : picknicktafel met trechter
ruit erop gewichtheffer : ruitjes gewichtheffen
brede smalle voet : pinocchio
stang erdoorheen breed : staaf erdoorheen ongelijk
twee verschillende roerstaafjes : lineaal penseel staafjes
dienblad en pacman handvat : dienblad en dakraam
bodemplaat met horens : pippi langkous ribbels
balletje erop : twee dunne armpjes
door vierkant plateau : ballerina
twee ovalen handvatten : twee ronde uitsteeksels
robot telescoop ogen : paddestoel twee telescopen
feesthoed en kogel : punthoed en kogel
afgekapt feesthoedje : afgekapt feesthoedje
raket met loopbrug : raket met vleugels
spijker door neus : stok door neus
afdakje : tafel door kop
afvoerbuis aan onderkant : platte vierkanten boven
cilinder bord lepel : lepel bord steelpan
deegroller door kop : deegroller
neus en meetlat : ronde neus steelpan
spijker door steel : spijker door bleekselderij
kop met vlechten : kop met vlechten
dunne armpjes : dunne armen
zwaaiend : plank door kop
uitsteeksels alle kanten : vier richtingen uitsteeksels
voorin een vierkant : paddenstoel
driehoek bovenop : vierkant bovenop
schroef driehoek onderin : schroef met voetstuk
twee rechthoeken rechts : twee streepjes rechts
links half prisma : balk bovenop
bol staaf schijf : bolletje balk schijf
tafeltje bakje bovenin : tafel
haakje onderin : kromme ding onderin
omgekeerde kegel rechtsboven : halve cirke
doorlopende staaf bol : balken schuin vlak
bol rechthoek boven : bol rechts
omgekeerde pion linksboven : omgekeerde pion
plateau onderin : onderste plank
bol bovenop : bal bovenop
twee streepjes boven : plank iets hoger
kegel boven links : twee kegels
robot met antenne : robot met antenne
gezicht hanenkam wielen : piramide kogel links
voetstuk beker vlag : trofee
spijker stopcontact hoed : stompe piramide spijker
simpel weinig zichtbaar : rechthoek boven pennetje
arm met hamer : hamer
tafelblad potje zweven : ontbijttafel met schaal
kat staart onder : staart pootjes kop
kook steelpan : steelpan smal plateau
ding dwars erdoorheen : doorborende staaf
opberg mok met neus : gereedschaps vaas met bol
kop met bekerhouder : pion bekerhouder
plateau met kristallen : drie kraaltjes
pedalen bal op : bal bovenop pedalen
zwaaiende olifant : zwaaiende olifant plateau
lange uitsteeksels : uitsteeksels omgekeerde toren
spijker en verrekijker : spijker blokkentorens vierkant
piramide op kopje : piramide en verrekijker
wijnglas met blokjes : glas met blokjes
lampenkap op kopje : lampenkap en balkjes
langwerpig blok erop : balk en toblerone
balkje door neus : spijker door bol
plank aan kopje : dienblad met lampenkap
ruit aan zijkant : strik
enkele uitstekende cilinder : cirkel aan zijkant
kopje overdwarse cilinder : springplank achter cilinders
kegel en blok : twee cilinder kopje
pylon aan linkerzijde : spijker in bank
kopje op onderzetter : kopje met diamantjes
balletje op kopje : balk voor mannetje
vierkant door kopje : vierkant door kopje
enkele kegel erop : scheepsroer
vierkant oor : de robot
punt hoofd : feesthoedje op wielen
draaikolk op standaard : het torentje
vogeltje met snavel : twitter vogel
leraar met stokje : het uiltje
piercing door neus : neus piercing
ober die serveert : mijn serveerder
pinokkio met arm : pinokkio met hanekam
pinokkio zonder arm : het gewone kopje
stompe handvatten : het afdakje
rond neus : dikke neus
spijker arm : jouw serveerder
gekke professor : de professor
olifantenslurf met armen : de waterleiding
zwembandje om middel : glijbaan met band
twee roerstaven : minecraft hand
twee blokjes balken : vierkant met schoorsteen
driehoek zijaanzicht gezicht : driekhoek met bolletje
gedraaide schroef onderaan : helix
zijaanzicht vogel : kip
compact met schuif bak : zuiger
neus doorboord : balk door neus
plateau met bakje : bankje
balk door ruit : ruit met balk
zijaanzicht pinokkio gezicht : halve cirkel gezicht
buis zonder plateau : gaspedaal
hoofd met voelsprieten : hoofd met vulpen
horizontaal platte cirkel : eifeltoren
ondergrond met object : bolletjes op vierkant
bol op theekop : ei hoofd mannetje
plateau door object : plateau door object
bowlingkegels hoek negentig graden : twee kegels
plat vierkant voorkant : platte vierkant ervoor
bovenkant driehoek : puntige driekhoek bovenop
op gedraaid voetstuk : gedraaid voetstuk driehoek
afgekapte driekhoek bovenop : eend
balk plat bovenop : balk plat bovenop
balk door bol : balk door rondje
vlak met pootjes : tafeltje
plat vierkant doorboord : ingewikkelde vierkant doorboord
plat ovaal achter : plat rondje erachter
scheef vierkant erachter : vierkant met steuntje
ronde bol voorkant : bovenop kegel balkje
ijspegel linker zijstuk : spijker in zijkant
drie bolletjes zijkanten : drie bolletjes zijkanten
verticale balk voorkant : balk ervoor
plat vierkant midden : pijpje linker zijkant
boven links kegel : kegels zijkant bovenkant
uitstekende ogen vierkant : paddestoel hoofd vierkant
driehoek pet : verrekijker piramide
driehoek voetstuk vierkantjes : draaiend voetstuk vierkantjes
propellers puntig staart : onderzeeer
staafje bovenop : balk hoofd afvoerputje
speer schildje in hand : clownsneus speer
draag rekje met bakje : picknicktafel mandje
hoekige uitsteeksels puntneus : een been ruit
roerstokje rondje staafje : roerstaafje plat voetstuk
staafjes handvat vierkantje : piemel mok
roerstaafjes bolletje staafje : clownsneus roerstaafje kwastje
opstapje handvat schoorsteen : dienblad
vierkant voetstuk handvatten : pippi langkous
balkje handvatjes balletje : bal paal stengel armen
vierkant eromheen staafjes : vierkante hoelahoep
armen staart punthoofd : staart uitbreidend vierkant
vlak rechts voor : verrekijker plaat paddenstoel
driehoek bovenop : feesthoed rare neus
blokje rechts boven : driehoek gedraaide poot
twee streepjes rechts : afgeplatte feesthoed
staafje liggend bovenop : balk afzuigkap
cirkel stokje rechts : neus piercing lepel
tafeltje rechts : picknickbank bak
vierkant pootje midden : satelliet hoofd
lepel rechts : zon
vlak links boven : vijzel
rondje rechts : cirkel dakgoot pen
spijker links : spijker hondenbot
groot vlak onder : pippi langkous
cirkel bovenop : bal bovenop
vlak rondom midden : plaat slurf deurklink
lepel recht omhoog : twee sambaballen
televisie houder met antenne : verrekijker met spijker
feestvarken met hoedje : verjaardags hoed grote neus
blij een benig poppetje : scheve trofee
cocktailshaker : zwemmende kip
rokende pinguin : paaseiland look-a-like
gewichts heffend koffiekopje : zuignap als speer
kortpotige kopje : half piramide hoofd
oordop dragend zeepaardje : toffee hoofd
opgehangen poppetje : staande pinokkio
kopje naast loopband : kanon met wasbord
kopje met lepels : kopje met lepels
kopje met dienblad : dienblad
kopje met muizentrapjes : ruit oren
kleine boom knuffelaar : pomp met ei
rokjes dragend kopje : tutu
drie verschillende armen : groter wordend vierkant
een spijker bovenop : schroef vierkant paneel
driehoek erop steuntje : driehoek bovenaan
schroef twee vierkantjes : schroef kaas
is gelijk aan : is gelijk aan
liggende balk bovenop : balk vleugels
balk schijf bal : gewichtheffer
soort bankje ervoor : springplank
haakje eronder voorkant : diertje dat klapt
cirkel erachter : ondersteuning cirkel kegel
links rechts paaltje : zonnepaneel schroef
drie verschillende staafjes : kookpotje
dienblad pikkel : pijl dienblad
vierkant blad eronder : kraaltjes
bal erop balk : balk rechterkant
glijbaan twee sprietjes : saturnus twee sprietjes
twee kegels : cactus
paddenstoel boven vierkant : paddenstoel
driehoek boven cilinder : kegel
twee kubussen boven : trofee
twee planken midden : wegwijzer
balk boven lampenkapje : klok
balk bal dorheen : olijf
tafelpoten met bakje : tafel soepkom
ruit balk doorheen : zeepaardje
cilinder midden pookje : pinokkio
vierkant boven cilinder : mri scanner spiegel
bol midden stekels : lepels
rond plankje puntig : spijker in arm
ribbel cilinder aandrijfwiel : kralen
bol boven balk : man knuffelt paal
twee staafjes boven : dansende olifant
pook boven pook midden : vier uitsteeksels
